"id_tester","id_item","pays","num_stimulus","rep_Z1","rep_Z2","rep_Z3","rep_Z4","rep_Z5","fix_tot","Temps_Z1","Temps_Z2","Temps_Z3","Temps_Z4","Temps_Z5","tps_tot"
"199d1269-1d8a-420a-a986-1f4f2ab4355f","34359006-f70f-438e-85d0-420cf2fe6944","Ukraine",156,3,7,1,1,4,16,2929,4762,199,661,1825,10376
"fd0537e8-3103-47f8-9998-44570bb8a45e","34359006-f70f-438e-85d0-420cf2fe6944","Ukraine",156,14,15,6,11,13,59,2807,2933,1243,3339,8623,18945
"e433aa11-cdb7-4733-88a9-7067cf52299b","34359006-f70f-438e-85d0-420cf2fe6944","Ukraine",156,21,8,4,23,16,72,5169,1401,1043,8543,6961,23117
"149c1889-4e83-4153-b763-54fb60e60d99","34359006-f70f-438e-85d0-420cf2fe6944","Ukraine",156,22,19,4,5,6,56,8734,5803,1142,1617,1894,19190
"14229a71-f44e-4149-9f3c-aa7415691eae","34359006-f70f-438e-85d0-420cf2fe6944","Ukraine",156,2,8,2,3,7,22,546,1573,1280,1729,2647,7775
"a724528f-7fe6-4ad6-bba1-21cb02db2af5","34359006-f70f-438e-85d0-420cf2fe6944","Ukraine",156,19,14,2,11,12,58,4814,5896,712,5884,8989,26295
"4f5ae77c-6112-401a-93d1-3bf44bd1ccbe","34359006-f70f-438e-85d0-420cf2fe6944","Ukraine",156,2,1,0,4,2,9,887,140,0,984,1010,3021
"4f147d0e-54ac-4b89-a269-aaa7819fb0ef","34359006-f70f-438e-85d0-420cf2fe6944","Ukraine",156,6,10,3,6,9,34,1522,3127,580,2494,2803,10526
"c464d108-c77f-41e7-bcbc-d5855c9a7968","34359006-f70f-438e-85d0-420cf2fe6944","Ukraine",156,13,12,11,7,11,54,6834,2847,2152,1826,9656,23315
"b20e7a20-ca68-410c-8214-fbb92bfdfe17","34359006-f70f-438e-85d0-420cf2fe6944","Ukraine",156,3,6,8,1,3,21,800,1908,2306,99,939,6052
"131f7620-d15d-4560-86ab-564145745b9b","34359006-f70f-438e-85d0-420cf2fe6944","Ukraine",156,5,10,4,5,9,33,2361,2400,1693,1573,5580,13607
"131ecf76-b806-4557-b2c0-183a418357ba","34359006-f70f-438e-85d0-420cf2fe6944","Ukraine",156,2,1,1,1,2,7,604,409,34,182,903,2132
"9560482a-f0a3-4f68-a311-03d22aedbd05","34359006-f70f-438e-85d0-420cf2fe6944","Ukraine",156,6,5,3,6,7,27,2721,1708,1005,1560,3246,10240
"10e732f6-9a6a-474a-82e2-a4060fc8dffe","34359006-f70f-438e-85d0-420cf2fe6944","Ukraine",156,7,9,3,6,10,35,3347,2672,1823,6404,8427,22673
"646465ef-0ad6-44cc-bd31-de24e1487943","34359006-f70f-438e-85d0-420cf2fe6944","Ukraine",156,6,8,6,5,8,33,1622,1303,2789,1978,3403,11095
"aa2c1d96-ec88-4bcb-8d0e-e2b0c7632af1","34359006-f70f-438e-85d0-420cf2fe6944","Ukraine",156,12,8,3,6,6,35,2885,1626,840,2033,3854,11238
"9610f0dd-ff9f-4bd4-b311-459a04f965ca","34359006-f70f-438e-85d0-420cf2fe6944","Ukraine",156,6,5,2,3,4,20,2228,672,623,1108,2010,6641
"df6523cd-3270-4298-8d6f-00aa8e9455e6","34359006-f70f-438e-85d0-420cf2fe6944","Ukraine",156,6,9,6,9,11,41,1544,2556,1852,4229,4856,15037
"54c68134-2c2a-4f2e-974b-32310830af0e","34359006-f70f-438e-85d0-420cf2fe6944","Ukraine",156,8,8,4,8,8,36,3391,2197,601,2106,4864,13159
"055d198c-f8b0-47b7-9eb3-94fc57808f93","34359006-f70f-438e-85d0-420cf2fe6944","Ukraine",156,6,17,10,0,2,35,1694,3403,2456,0,1006,8559
"cea293cd-b0b1-40ea-8e71-756b3956e8ad","34359006-f70f-438e-85d0-420cf2fe6944","Ukraine",156,6,11,3,6,9,35,2734,5215,951,2457,3896,15253
"de86783a-ac86-419a-a230-dad6b421fba4","34359006-f70f-438e-85d0-420cf2fe6944","Ukraine",156,3,5,4,4,5,21,2001,942,712,1527,2564,7746
"919c7921-7cef-4620-a2fe-766180ed2fbb","34359006-f70f-438e-85d0-420cf2fe6944","Ukraine",156,5,7,5,4,6,27,1299,2176,1570,1198,1976,8219
"9f8068fd-f5cc-4e1a-946a-c9beb8b4d05a","34359006-f70f-438e-85d0-420cf2fe6944","Ukraine",156,3,1,5,5,7,21,1203,78,1358,1426,2141,6206
"06026e76-f9a4-4fb9-877d-bcd33373cdab","34359006-f70f-438e-85d0-420cf2fe6944","Ukraine",156,15,25,10,13,15,78,3405,7933,2383,3216,6750,23687
"27e050a3-45e8-4076-9c25-32be9040da4e","34359006-f70f-438e-85d0-420cf2fe6944","Ukraine",156,3,7,0,4,5,19,1678,3690,0,2061,4329,11758
"4995f6d3-50ed-427d-9cf2-4ea0b81a229c","34359006-f70f-438e-85d0-420cf2fe6944","Ukraine",156,2,5,2,5,5,19,422,2180,266,2258,2367,7493
"398e712a-fae6-451d-83c9-a7e500227e62","34359006-f70f-438e-85d0-420cf2fe6944","Ukraine",156,2,3,1,2,1,9,432,497,74,176,0,1179
"65681129-f83c-4293-9ce3-9d1429367fd0","34359006-f70f-438e-85d0-420cf2fe6944","Ukraine",156,6,12,5,12,14,49,1975,3164,2958,3889,4514,16500
"035a43cf-cf88-4675-85e7-11eeb0b3641c","34359006-f70f-438e-85d0-420cf2fe6944","Ukraine",156,19,14,7,9,8,57,9675,6324,2017,4933,3972,26921
"aaf1dbcb-3748-4740-a2e0-58e7c1cb9f78","34359006-f70f-438e-85d0-420cf2fe6944","Ukraine",156,5,5,2,3,2,17,1210,536,781,998,1657,5182
"bf743fbf-9be2-49a1-bf7e-0b53276e6529","34359006-f70f-438e-85d0-420cf2fe6944","Ukraine",156,3,3,3,2,3,14,1200,595,1260,368,2387,5810
"cd0a0a46-7676-4bf0-ad03-2e83bd565fee","34359006-f70f-438e-85d0-420cf2fe6944","Ukraine",156,3,4,0,3,3,13,1149,1284,0,821,1265,4519
"9577727a-fa45-4185-9778-4a56a41cf0f6","34359006-f70f-438e-85d0-420cf2fe6944","Ukraine",156,2,2,1,2,3,10,419,821,331,1152,2008,4731
"073891b7-a928-4ff0-83e3-56f4d1a6315e","34359006-f70f-438e-85d0-420cf2fe6944","Ukraine",156,3,8,4,2,4,21,712,3650,1134,998,2852,9346
"cc933e0b-091f-4ef4-bfc8-11f2076d4396","34359006-f70f-438e-85d0-420cf2fe6944","Ukraine",156,7,13,5,11,6,42,1492,3314,433,4506,2172,11917
"4ed0a862-3163-449b-bb48-ca8b9ce3add0","34359006-f70f-438e-85d0-420cf2fe6944","Ukraine",156,15,21,5,6,11,58,3895,8406,1868,1126,3834,19129
"473d2e90-02dd-483e-ad19-3966ec20050a","34359006-f70f-438e-85d0-420cf2fe6944","Ukraine",156,3,4,3,2,4,16,1264,1106,615,634,2194,5813
"03964ff9-d24f-4a0a-a492-3a177e16eb11","34359006-f70f-438e-85d0-420cf2fe6944","Ukraine",156,3,5,2,4,5,19,1844,1599,360,1405,1732,6940
"e87291fb-8da5-4c7a-af30-4413737f2401","34359006-f70f-438e-85d0-420cf2fe6944","Ukraine",156,5,7,2,2,4,20,2011,1412,461,1158,679,5721
"915ec45f-204b-411d-8ed7-7fdecb385e39","34359006-f70f-438e-85d0-420cf2fe6944","Ukraine",156,14,19,7,9,11,60,3670,7523,3481,5621,6160,26455
"199d1269-1d8a-420a-a986-1f4f2ab4355f","20f3c152-6ebf-49db-8e1a-00eebd99feb6","Finland",672,6,5,6,8,4,29,4101,2418,1791,5419,1584,15313
"fd0537e8-3103-47f8-9998-44570bb8a45e","20f3c152-6ebf-49db-8e1a-00eebd99feb6","Finland",672,7,3,9,10,11,40,2261,1606,2100,1858,5334,13159
"e433aa11-cdb7-4733-88a9-7067cf52299b","20f3c152-6ebf-49db-8e1a-00eebd99feb6","Finland",672,5,4,13,11,6,39,1191,659,5311,3041,2241,12443
"149c1889-4e83-4153-b763-54fb60e60d99","20f3c152-6ebf-49db-8e1a-00eebd99feb6","Finland",672,17,5,19,13,4,58,7933,2229,11980,4146,868,27156
"14229a71-f44e-4149-9f3c-aa7415691eae","20f3c152-6ebf-49db-8e1a-00eebd99feb6","Finland",672,2,1,2,2,2,9,1635,500,375,1163,609,4282
"a724528f-7fe6-4ad6-bba1-21cb02db2af5","20f3c152-6ebf-49db-8e1a-00eebd99feb6","Finland",672,8,5,11,15,9,48,3289,3196,3653,3709,5139,18986
"4f5ae77c-6112-401a-93d1-3bf44bd1ccbe","20f3c152-6ebf-49db-8e1a-00eebd99feb6","Finland",672,5,2,2,5,2,16,1828,674,869,1482,563,5416
"4f147d0e-54ac-4b89-a269-aaa7819fb0ef","20f3c152-6ebf-49db-8e1a-00eebd99feb6","Finland",672,8,4,7,7,5,31,3185,2492,1731,1414,1289,10111
"c464d108-c77f-41e7-bcbc-d5855c9a7968","20f3c152-6ebf-49db-8e1a-00eebd99feb6","Finland",672,15,7,18,25,17,82,6392,2212,5862,4635,6469,25570
"b20e7a20-ca68-410c-8214-fbb92bfdfe17","20f3c152-6ebf-49db-8e1a-00eebd99feb6","Finland",672,3,3,1,1,2,10,1104,1412,428,562,247,3753
"131f7620-d15d-4560-86ab-564145745b9b","20f3c152-6ebf-49db-8e1a-00eebd99feb6","Finland",672,13,12,4,9,15,53,3474,6131,2010,2059,5521,19195
"131ecf76-b806-4557-b2c0-183a418357ba","20f3c152-6ebf-49db-8e1a-00eebd99feb6","Finland",672,5,1,3,8,5,22,4236,657,1831,3814,1652,12190
"9560482a-f0a3-4f68-a311-03d22aedbd05","20f3c152-6ebf-49db-8e1a-00eebd99feb6","Finland",672,6,3,7,7,4,27,2240,1604,1589,1540,809,7782
"10e732f6-9a6a-474a-82e2-a4060fc8dffe","20f3c152-6ebf-49db-8e1a-00eebd99feb6","Finland",672,7,4,10,13,8,42,5106,1614,2071,3669,4541,17001
"646465ef-0ad6-44cc-bd31-de24e1487943","20f3c152-6ebf-49db-8e1a-00eebd99feb6","Finland",672,9,5,7,6,8,35,3514,1789,2573,2065,2306,12247
"aa2c1d96-ec88-4bcb-8d0e-e2b0c7632af1","20f3c152-6ebf-49db-8e1a-00eebd99feb6","Finland",672,13,9,10,12,7,51,5503,4724,4480,4769,1878,21354
"9610f0dd-ff9f-4bd4-b311-459a04f965ca","20f3c152-6ebf-49db-8e1a-00eebd99feb6","Finland",672,9,6,8,13,10,46,2560,2983,2445,4027,3432,15447
"df6523cd-3270-4298-8d6f-00aa8e9455e6","20f3c152-6ebf-49db-8e1a-00eebd99feb6","Finland",672,15,14,8,7,9,53,7180,5514,2211,2263,3854,21022
"54c68134-2c2a-4f2e-974b-32310830af0e","20f3c152-6ebf-49db-8e1a-00eebd99feb6","Finland",672,6,9,4,9,12,40,4426,2981,2960,3497,4565,18429
"055d198c-f8b0-47b7-9eb3-94fc57808f93","20f3c152-6ebf-49db-8e1a-00eebd99feb6","Finland",672,5,4,7,8,4,28,2122,1758,2659,1430,956,8925
"cea293cd-b0b1-40ea-8e71-756b3956e8ad","20f3c152-6ebf-49db-8e1a-00eebd99feb6","Finland",672,9,8,4,12,10,43,2351,2895,1365,10650,4768,22029
"de86783a-ac86-419a-a230-dad6b421fba4","20f3c152-6ebf-49db-8e1a-00eebd99feb6","Finland",672,10,10,9,11,8,48,6290,6501,3857,3434,2094,22176
"919c7921-7cef-4620-a2fe-766180ed2fbb","20f3c152-6ebf-49db-8e1a-00eebd99feb6","Finland",672,3,3,2,6,3,17,1492,1802,514,2260,743,6811
"9f8068fd-f5cc-4e1a-946a-c9beb8b4d05a","20f3c152-6ebf-49db-8e1a-00eebd99feb6","Finland",672,4,4,4,6,4,22,1149,1369,1453,1070,1101,6142
"06026e76-f9a4-4fb9-877d-bcd33373cdab","20f3c152-6ebf-49db-8e1a-00eebd99feb6","Finland",672,6,3,9,14,6,38,1718,2188,5388,4267,2016,15577
"27e050a3-45e8-4076-9c25-32be9040da4e","20f3c152-6ebf-49db-8e1a-00eebd99feb6","Finland",672,1,0,0,3,2,6,1028,0,0,1139,3069,5236
"4995f6d3-50ed-427d-9cf2-4ea0b81a229c","20f3c152-6ebf-49db-8e1a-00eebd99feb6","Finland",672,11,9,3,7,3,33,3252,4040,1512,1762,805,11371
"398e712a-fae6-451d-83c9-a7e500227e62","20f3c152-6ebf-49db-8e1a-00eebd99feb6","Finland",672,5,3,1,2,0,11,2745,1213,237,1122,0,5317
"65681129-f83c-4293-9ce3-9d1429367fd0","20f3c152-6ebf-49db-8e1a-00eebd99feb6","Finland",672,19,11,3,4,0,37,5662,8243,793,1168,0,15866
"035a43cf-cf88-4675-85e7-11eeb0b3641c","20f3c152-6ebf-49db-8e1a-00eebd99feb6","Finland",672,6,8,10,11,6,41,1807,2368,3058,2825,1689,11747
"aaf1dbcb-3748-4740-a2e0-58e7c1cb9f78","20f3c152-6ebf-49db-8e1a-00eebd99feb6","Finland",672,5,6,7,6,10,34,3119,1948,1708,910,1717,9402
"bf743fbf-9be2-49a1-bf7e-0b53276e6529","20f3c152-6ebf-49db-8e1a-00eebd99feb6","Finland",672,3,2,1,6,5,17,2684,463,170,1390,1084,5791
"cd0a0a46-7676-4bf0-ad03-2e83bd565fee","20f3c152-6ebf-49db-8e1a-00eebd99feb6","Finland",672,5,5,9,13,4,36,2956,1981,3510,8816,1578,18841
"9577727a-fa45-4185-9778-4a56a41cf0f6","20f3c152-6ebf-49db-8e1a-00eebd99feb6","Finland",672,9,7,4,6,7,33,4843,4346,907,3381,2648,16125
"073891b7-a928-4ff0-83e3-56f4d1a6315e","20f3c152-6ebf-49db-8e1a-00eebd99feb6","Finland",672,6,5,2,5,5,23,3742,3670,446,2245,1616,11719
"cc933e0b-091f-4ef4-bfc8-11f2076d4396","20f3c152-6ebf-49db-8e1a-00eebd99feb6","Finland",672,8,3,9,9,2,31,2587,903,2716,1940,405,8551
"4ed0a862-3163-449b-bb48-ca8b9ce3add0","20f3c152-6ebf-49db-8e1a-00eebd99feb6","Finland",672,12,8,16,21,11,68,3961,2630,4942,5536,4317,21386
"473d2e90-02dd-483e-ad19-3966ec20050a","20f3c152-6ebf-49db-8e1a-00eebd99feb6","Finland",672,7,7,3,7,8,32,3781,2268,830,2219,2154,11252
"03964ff9-d24f-4a0a-a492-3a177e16eb11","20f3c152-6ebf-49db-8e1a-00eebd99feb6","Finland",672,5,4,3,7,3,22,2521,3278,1189,1575,813,9376
"e87291fb-8da5-4c7a-af30-4413737f2401","20f3c152-6ebf-49db-8e1a-00eebd99feb6","Finland",672,4,2,1,2,0,9,3360,884,349,668,0,5261
"915ec45f-204b-411d-8ed7-7fdecb385e39","20f3c152-6ebf-49db-8e1a-00eebd99feb6","Finland",672,13,6,16,16,5,56,5353,2872,6144,7091,2524,23984
"199d1269-1d8a-420a-a986-1f4f2ab4355f","213479f7-39af-4b83-b0e9-4ba473d27429","Spain",756,1,6,4,4,12,27,241,3633,2757,3603,4858,15092
"fd0537e8-3103-47f8-9998-44570bb8a45e","213479f7-39af-4b83-b0e9-4ba473d27429","Spain",756,6,10,5,23,18,62,1605,3509,3337,7009,8177,23637
"e433aa11-cdb7-4733-88a9-7067cf52299b","213479f7-39af-4b83-b0e9-4ba473d27429","Spain",756,5,6,3,7,15,36,380,1523,1135,2742,6575,12355
"149c1889-4e83-4153-b763-54fb60e60d99","213479f7-39af-4b83-b0e9-4ba473d27429","Spain",756,1,5,5,3,6,20,97,2205,1439,981,4704,9426
"14229a71-f44e-4149-9f3c-aa7415691eae","213479f7-39af-4b83-b0e9-4ba473d27429","Spain",756,2,6,6,4,7,25,463,2672,2722,1494,4839,12190
"a724528f-7fe6-4ad6-bba1-21cb02db2af5","213479f7-39af-4b83-b0e9-4ba473d27429","Spain",756,3,5,4,14,19,45,2348,720,1456,6408,9665,20597
"4f5ae77c-6112-401a-93d1-3bf44bd1ccbe","213479f7-39af-4b83-b0e9-4ba473d27429","Spain",756,3,4,2,3,3,15,995,802,692,441,1324,4254
"4f147d0e-54ac-4b89-a269-aaa7819fb0ef","213479f7-39af-4b83-b0e9-4ba473d27429","Spain",756,1,3,2,1,5,12,348,691,1246,269,1062,3616
"c464d108-c77f-41e7-bcbc-d5855c9a7968","213479f7-39af-4b83-b0e9-4ba473d27429","Spain",756,3,7,3,5,5,23,856,1074,1326,1050,1794,6100
"b20e7a20-ca68-410c-8214-fbb92bfdfe17","213479f7-39af-4b83-b0e9-4ba473d27429","Spain",756,4,11,10,9,14,48,1332,3937,2787,1939,3640,13635
"131f7620-d15d-4560-86ab-564145745b9b","213479f7-39af-4b83-b0e9-4ba473d27429","Spain",756,1,4,2,3,6,16,328,1483,1665,1325,4319,9120
"131ecf76-b806-4557-b2c0-183a418357ba","213479f7-39af-4b83-b0e9-4ba473d27429","Spain",756,2,2,2,5,7,18,417,981,609,747,2798,5552
"9560482a-f0a3-4f68-a311-03d22aedbd05","213479f7-39af-4b83-b0e9-4ba473d27429","Spain",756,1,4,7,2,3,17,376,953,2625,1399,971,6324
"10e732f6-9a6a-474a-82e2-a4060fc8dffe","213479f7-39af-4b83-b0e9-4ba473d27429","Spain",756,3,3,8,2,13,29,1097,653,4496,484,9282,16012
"646465ef-0ad6-44cc-bd31-de24e1487943","213479f7-39af-4b83-b0e9-4ba473d27429","Spain",756,7,17,14,10,13,61,3751,6146,4764,3806,6609,25076
"aa2c1d96-ec88-4bcb-8d0e-e2b0c7632af1","213479f7-39af-4b83-b0e9-4ba473d27429","Spain",756,5,6,5,6,11,33,1189,3105,2932,2239,4001,13466
"9610f0dd-ff9f-4bd4-b311-459a04f965ca","213479f7-39af-4b83-b0e9-4ba473d27429","Spain",756,3,7,3,5,7,25,616,1275,926,1400,2018,6235
"df6523cd-3270-4298-8d6f-00aa8e9455e6","213479f7-39af-4b83-b0e9-4ba473d27429","Spain",756,6,17,16,10,18,67,2558,5428,6145,3141,8314,25586
"54c68134-2c2a-4f2e-974b-32310830af0e","213479f7-39af-4b83-b0e9-4ba473d27429","Spain",756,2,4,6,7,9,28,477,1153,1130,1684,5131,9575
"055d198c-f8b0-47b7-9eb3-94fc57808f93","213479f7-39af-4b83-b0e9-4ba473d27429","Spain",756,6,6,5,3,5,25,1452,1202,1930,1595,3007,9186
"cea293cd-b0b1-40ea-8e71-756b3956e8ad","213479f7-39af-4b83-b0e9-4ba473d27429","Spain",756,3,11,6,5,8,33,1144,2631,1764,2129,8024,15692
"de86783a-ac86-419a-a230-dad6b421fba4","213479f7-39af-4b83-b0e9-4ba473d27429","Spain",756,3,7,4,2,4,20,629,2444,2081,1603,1428,8185
"919c7921-7cef-4620-a2fe-766180ed2fbb","213479f7-39af-4b83-b0e9-4ba473d27429","Spain",756,5,6,4,10,12,37,811,1159,1351,3297,5271,11889
"9f8068fd-f5cc-4e1a-946a-c9beb8b4d05a","213479f7-39af-4b83-b0e9-4ba473d27429","Spain",756,4,7,5,6,6,28,755,1668,1647,1522,2060,7652
"06026e76-f9a4-4fb9-877d-bcd33373cdab","213479f7-39af-4b83-b0e9-4ba473d27429","Spain",756,4,8,3,11,13,39,1009,1836,1016,7809,7104,18774
"27e050a3-45e8-4076-9c25-32be9040da4e","213479f7-39af-4b83-b0e9-4ba473d27429","Spain",756,1,4,5,1,7,18,374,3658,1451,154,6158,11795
"4995f6d3-50ed-427d-9cf2-4ea0b81a229c","213479f7-39af-4b83-b0e9-4ba473d27429","Spain",756,3,8,3,7,11,32,1449,2648,1677,2950,5634,14358
"398e712a-fae6-451d-83c9-a7e500227e62","213479f7-39af-4b83-b0e9-4ba473d27429","Spain",756,4,7,3,2,6,22,796,2154,831,715,2593,7089
"65681129-f83c-4293-9ce3-9d1429367fd0","213479f7-39af-4b83-b0e9-4ba473d27429","Spain",756,2,7,6,5,3,23,440,1484,1575,1917,827,6243
"035a43cf-cf88-4675-85e7-11eeb0b3641c","213479f7-39af-4b83-b0e9-4ba473d27429","Spain",756,5,7,7,6,9,34,3204,2660,3785,2099,5570,17318
"aaf1dbcb-3748-4740-a2e0-58e7c1cb9f78","213479f7-39af-4b83-b0e9-4ba473d27429","Spain",756,2,7,6,5,7,27,726,1695,3270,1993,3523,11207
"bf743fbf-9be2-49a1-bf7e-0b53276e6529","213479f7-39af-4b83-b0e9-4ba473d27429","Spain",756,1,6,4,3,7,21,421,1413,1030,612,3947,7423
"cd0a0a46-7676-4bf0-ad03-2e83bd565fee","213479f7-39af-4b83-b0e9-4ba473d27429","Spain",756,1,6,6,1,7,21,81,2560,2231,350,4150,9372
"9577727a-fa45-4185-9778-4a56a41cf0f6","213479f7-39af-4b83-b0e9-4ba473d27429","Spain",756,2,6,3,1,4,16,741,2720,835,513,3668,8477
"073891b7-a928-4ff0-83e3-56f4d1a6315e","213479f7-39af-4b83-b0e9-4ba473d27429","Spain",756,1,3,1,4,4,13,1199,792,252,1385,3853,7481
"cc933e0b-091f-4ef4-bfc8-11f2076d4396","213479f7-39af-4b83-b0e9-4ba473d27429","Spain",756,3,7,5,5,8,28,778,3245,2977,790,6013,13803
"4ed0a862-3163-449b-bb48-ca8b9ce3add0","213479f7-39af-4b83-b0e9-4ba473d27429","Spain",756,1,4,5,4,7,21,214,775,1263,2159,4636,9047
"473d2e90-02dd-483e-ad19-3966ec20050a","213479f7-39af-4b83-b0e9-4ba473d27429","Spain",756,3,4,2,3,6,18,377,1643,1386,1053,2931,7390
"03964ff9-d24f-4a0a-a492-3a177e16eb11","213479f7-39af-4b83-b0e9-4ba473d27429","Spain",756,3,2,1,2,4,12,1331,1121,189,468,2170,5279
"e87291fb-8da5-4c7a-af30-4413737f2401","213479f7-39af-4b83-b0e9-4ba473d27429","Spain",756,2,2,1,3,2,10,257,613,381,865,1257,3373
"915ec45f-204b-411d-8ed7-7fdecb385e39","213479f7-39af-4b83-b0e9-4ba473d27429","Spain",756,7,15,7,14,15,58,2246,6791,4055,5065,8039,26196
"199d1269-1d8a-420a-a986-1f4f2ab4355f","7bdf6ed6-acf9-4a7b-84fe-7e4f96f9582a","France",421,2,3,3,5,0,13,567,1916,701,3838,0,7022
"fd0537e8-3103-47f8-9998-44570bb8a45e","7bdf6ed6-acf9-4a7b-84fe-7e4f96f9582a","France",421,0,1,0,4,1,6,0,282,0,1042,142,1466
"e433aa11-cdb7-4733-88a9-7067cf52299b","7bdf6ed6-acf9-4a7b-84fe-7e4f96f9582a","France",421,4,3,2,12,6,27,2085,764,358,6642,988,10837
"149c1889-4e83-4153-b763-54fb60e60d99","7bdf6ed6-acf9-4a7b-84fe-7e4f96f9582a","France",421,5,8,5,12,6,36,1310,3557,1036,8031,1410,15344
"14229a71-f44e-4149-9f3c-aa7415691eae","7bdf6ed6-acf9-4a7b-84fe-7e4f96f9582a","France",421,6,9,5,8,4,32,3056,3311,2439,3698,241,12745
"a724528f-7fe6-4ad6-bba1-21cb02db2af5","7bdf6ed6-acf9-4a7b-84fe-7e4f96f9582a","France",421,6,12,5,15,6,44,1080,2556,2381,9594,1653,17264
"4f5ae77c-6112-401a-93d1-3bf44bd1ccbe","7bdf6ed6-acf9-4a7b-84fe-7e4f96f9582a","France",421,2,2,3,3,1,11,914,84,911,1495,697,4101
"4f147d0e-54ac-4b89-a269-aaa7819fb0ef","7bdf6ed6-acf9-4a7b-84fe-7e4f96f9582a","France",421,5,8,2,10,6,31,1095,2563,473,3084,1195,8410
"c464d108-c77f-41e7-bcbc-d5855c9a7968","7bdf6ed6-acf9-4a7b-84fe-7e4f96f9582a","France",421,3,10,6,8,4,31,724,1976,2902,3842,1620,11064
"b20e7a20-ca68-410c-8214-fbb92bfdfe17","7bdf6ed6-acf9-4a7b-84fe-7e4f96f9582a","France",421,2,3,2,4,6,17,516,190,811,1846,476,3839
"131f7620-d15d-4560-86ab-564145745b9b","7bdf6ed6-acf9-4a7b-84fe-7e4f96f9582a","France",421,2,3,2,9,3,19,352,418,799,3677,783,6029
"131ecf76-b806-4557-b2c0-183a418357ba","7bdf6ed6-acf9-4a7b-84fe-7e4f96f9582a","France",421,2,7,4,7,4,24,804,2353,1271,2523,2516,9467
"9560482a-f0a3-4f68-a311-03d22aedbd05","7bdf6ed6-acf9-4a7b-84fe-7e4f96f9582a","France",421,5,5,4,3,5,22,1036,903,1013,1487,1492,5931
"10e732f6-9a6a-474a-82e2-a4060fc8dffe","7bdf6ed6-acf9-4a7b-84fe-7e4f96f9582a","France",421,2,5,5,14,6,32,1376,996,1617,9580,1184,14753
"646465ef-0ad6-44cc-bd31-de24e1487943","7bdf6ed6-acf9-4a7b-84fe-7e4f96f9582a","France",421,11,20,14,7,4,56,4692,11957,7436,4169,697,28951
"aa2c1d96-ec88-4bcb-8d0e-e2b0c7632af1","7bdf6ed6-acf9-4a7b-84fe-7e4f96f9582a","France",421,4,9,9,13,4,39,972,2528,3608,5460,1503,14071
"9610f0dd-ff9f-4bd4-b311-459a04f965ca","7bdf6ed6-acf9-4a7b-84fe-7e4f96f9582a","France",421,2,4,1,6,2,15,940,1325,268,3213,593,6339
"df6523cd-3270-4298-8d6f-00aa8e9455e6","7bdf6ed6-acf9-4a7b-84fe-7e4f96f9582a","France",421,3,5,9,6,2,25,992,1939,5001,2301,665,10898
"54c68134-2c2a-4f2e-974b-32310830af0e","7bdf6ed6-acf9-4a7b-84fe-7e4f96f9582a","France",421,4,6,2,1,1,14,1108,1490,1096,800,263,4757
"055d198c-f8b0-47b7-9eb3-94fc57808f93","7bdf6ed6-acf9-4a7b-84fe-7e4f96f9582a","France",421,7,9,7,5,7,35,2867,4100,2882,4245,1442,15536
"cea293cd-b0b1-40ea-8e71-756b3956e8ad","7bdf6ed6-acf9-4a7b-84fe-7e4f96f9582a","France",421,1,5,4,5,1,16,439,1030,1156,2466,305,5396
"de86783a-ac86-419a-a230-dad6b421fba4","7bdf6ed6-acf9-4a7b-84fe-7e4f96f9582a","France",421,4,6,3,12,6,31,1136,1459,805,5754,1259,10413
"919c7921-7cef-4620-a2fe-766180ed2fbb","7bdf6ed6-acf9-4a7b-84fe-7e4f96f9582a","France",421,6,4,0,4,9,23,1261,1389,0,3542,4284,10476
"9f8068fd-f5cc-4e1a-946a-c9beb8b4d05a","7bdf6ed6-acf9-4a7b-84fe-7e4f96f9582a","France",421,3,4,2,4,3,16,1472,1361,526,1699,563,5621
"06026e76-f9a4-4fb9-877d-bcd33373cdab","7bdf6ed6-acf9-4a7b-84fe-7e4f96f9582a","France",421,7,9,6,9,8,39,2109,2947,2445,3455,3021,13977
"27e050a3-45e8-4076-9c25-32be9040da4e","7bdf6ed6-acf9-4a7b-84fe-7e4f96f9582a","France",421,0,2,5,9,0,16,0,811,1892,3818,0,6521
"4995f6d3-50ed-427d-9cf2-4ea0b81a229c","7bdf6ed6-acf9-4a7b-84fe-7e4f96f9582a","France",421,12,11,8,10,12,53,4584,4335,3227,6409,4092,22647
"398e712a-fae6-451d-83c9-a7e500227e62","7bdf6ed6-acf9-4a7b-84fe-7e4f96f9582a","France",421,1,5,3,2,0,11,434,1350,685,420,0,2889
"65681129-f83c-4293-9ce3-9d1429367fd0","7bdf6ed6-acf9-4a7b-84fe-7e4f96f9582a","France",421,9,13,8,13,8,51,3435,3466,3664,4232,2506,17303
"035a43cf-cf88-4675-85e7-11eeb0b3641c","7bdf6ed6-acf9-4a7b-84fe-7e4f96f9582a","France",421,2,6,2,6,6,22,286,1535,379,2514,1238,5952
"aaf1dbcb-3748-4740-a2e0-58e7c1cb9f78","7bdf6ed6-acf9-4a7b-84fe-7e4f96f9582a","France",421,6,13,4,16,8,47,1772,2528,1187,5031,1646,12164
"bf743fbf-9be2-49a1-bf7e-0b53276e6529","7bdf6ed6-acf9-4a7b-84fe-7e4f96f9582a","France",421,0,3,11,6,1,21,0,1006,3093,4420,246,8765
"cd0a0a46-7676-4bf0-ad03-2e83bd565fee","7bdf6ed6-acf9-4a7b-84fe-7e4f96f9582a","France",421,0,8,5,7,1,21,0,2463,2557,3743,291,9054
"9577727a-fa45-4185-9778-4a56a41cf0f6","7bdf6ed6-acf9-4a7b-84fe-7e4f96f9582a","France",421,2,5,1,5,1,14,654,3221,365,4868,324,9432
"073891b7-a928-4ff0-83e3-56f4d1a6315e","7bdf6ed6-acf9-4a7b-84fe-7e4f96f9582a","France",421,4,8,3,4,1,20,3037,2476,820,2390,97,8820
"cc933e0b-091f-4ef4-bfc8-11f2076d4396","7bdf6ed6-acf9-4a7b-84fe-7e4f96f9582a","France",421,7,9,4,8,8,36,2489,3558,2369,4819,1183,14418
"4ed0a862-3163-449b-bb48-ca8b9ce3add0","7bdf6ed6-acf9-4a7b-84fe-7e4f96f9582a","France",421,2,5,3,10,7,27,184,1757,933,5367,1834,10075
"473d2e90-02dd-483e-ad19-3966ec20050a","7bdf6ed6-acf9-4a7b-84fe-7e4f96f9582a","France",421,2,2,3,3,3,13,492,1272,895,2009,713,5381
"03964ff9-d24f-4a0a-a492-3a177e16eb11","7bdf6ed6-acf9-4a7b-84fe-7e4f96f9582a","France",421,2,1,0,8,4,15,573,274,0,3721,1387,5955
"e87291fb-8da5-4c7a-af30-4413737f2401","7bdf6ed6-acf9-4a7b-84fe-7e4f96f9582a","France",421,3,6,2,3,1,15,723,1546,457,1460,427,4613
"915ec45f-204b-411d-8ed7-7fdecb385e39","7bdf6ed6-acf9-4a7b-84fe-7e4f96f9582a","France",421,5,13,10,18,10,56,836,3685,5169,9545,2361,21596
"199d1269-1d8a-420a-a986-1f4f2ab4355f","cc2a8b56-732c-4e4c-a058-248783b68587","South Korea",489,6,12,11,10,20,59,2474,3124,4512,6273,7513,23896
"fd0537e8-3103-47f8-9998-44570bb8a45e","cc2a8b56-732c-4e4c-a058-248783b68587","South Korea",489,6,8,4,12,16,46,1575,3155,1378,2971,6897,15976
"e433aa11-cdb7-4733-88a9-7067cf52299b","cc2a8b56-732c-4e4c-a058-248783b68587","South Korea",489,13,9,4,12,10,48,4410,2361,1114,4059,4950,16894
"149c1889-4e83-4153-b763-54fb60e60d99","cc2a8b56-732c-4e4c-a058-248783b68587","South Korea",489,5,5,2,10,6,28,1265,1593,921,6781,2876,13436
"14229a71-f44e-4149-9f3c-aa7415691eae","cc2a8b56-732c-4e4c-a058-248783b68587","South Korea",489,3,9,6,5,9,32,1067,2322,2889,3529,5718,15525
"a724528f-7fe6-4ad6-bba1-21cb02db2af5","cc2a8b56-732c-4e4c-a058-248783b68587","South Korea",489,7,15,8,9,14,53,1472,3076,6025,7487,9300,27360
"4f5ae77c-6112-401a-93d1-3bf44bd1ccbe","cc2a8b56-732c-4e4c-a058-248783b68587","South Korea",489,1,2,1,4,4,12,502,272,840,1303,1945,4862
"4f147d0e-54ac-4b89-a269-aaa7819fb0ef","cc2a8b56-732c-4e4c-a058-248783b68587","South Korea",489,5,6,3,4,7,25,1081,1595,1223,2455,5021,11375
"c464d108-c77f-41e7-bcbc-d5855c9a7968","cc2a8b56-732c-4e4c-a058-248783b68587","South Korea",489,6,9,8,7,12,42,2518,2124,4357,6254,7243,22496
"b20e7a20-ca68-410c-8214-fbb92bfdfe17","cc2a8b56-732c-4e4c-a058-248783b68587","South Korea",489,6,7,3,4,4,24,1411,2385,860,1324,944,6924
"131f7620-d15d-4560-86ab-564145745b9b","cc2a8b56-732c-4e4c-a058-248783b68587","South Korea",489,3,5,1,4,8,21,526,1704,130,3072,8107,13539
"131ecf76-b806-4557-b2c0-183a418357ba","cc2a8b56-732c-4e4c-a058-248783b68587","South Korea",489,3,1,1,3,1,9,1255,17,583,1161,1339,4355
"9560482a-f0a3-4f68-a311-03d22aedbd05","cc2a8b56-732c-4e4c-a058-248783b68587","South Korea",489,5,3,2,3,3,16,1288,360,709,681,530,3568
"10e732f6-9a6a-474a-82e2-a4060fc8dffe","cc2a8b56-732c-4e4c-a058-248783b68587","South Korea",489,0,5,6,4,12,27,0,1043,1160,3188,3688,9079
"646465ef-0ad6-44cc-bd31-de24e1487943","cc2a8b56-732c-4e4c-a058-248783b68587","South Korea",489,11,18,4,10,15,58,4356,8074,3075,1773,8023,25301
"aa2c1d96-ec88-4bcb-8d0e-e2b0c7632af1","cc2a8b56-732c-4e4c-a058-248783b68587","South Korea",489,3,9,4,4,6,26,2086,1991,1901,2819,4090,12887
"9610f0dd-ff9f-4bd4-b311-459a04f965ca","cc2a8b56-732c-4e4c-a058-248783b68587","South Korea",489,4,2,2,6,8,22,1098,945,1075,3236,3154,9508
"df6523cd-3270-4298-8d6f-00aa8e9455e6","cc2a8b56-732c-4e4c-a058-248783b68587","South Korea",489,0,8,14,2,7,31,0,1772,7522,1609,4650,15553
"54c68134-2c2a-4f2e-974b-32310830af0e","cc2a8b56-732c-4e4c-a058-248783b68587","South Korea",489,2,4,15,7,14,42,575,1355,5950,4751,8946,21577
"055d198c-f8b0-47b7-9eb3-94fc57808f93","cc2a8b56-732c-4e4c-a058-248783b68587","South Korea",489,4,4,5,3,5,21,1713,1300,1645,347,3538,8543
"cea293cd-b0b1-40ea-8e71-756b3956e8ad","cc2a8b56-732c-4e4c-a058-248783b68587","South Korea",489,1,5,3,3,3,15,252,988,976,473,8047,10736
"de86783a-ac86-419a-a230-dad6b421fba4","cc2a8b56-732c-4e4c-a058-248783b68587","South Korea",489,2,4,2,2,4,14,677,1533,1759,3020,3272,10261
"919c7921-7cef-4620-a2fe-766180ed2fbb","cc2a8b56-732c-4e4c-a058-248783b68587","South Korea",489,7,8,4,16,10,45,2176,1631,2644,2952,4750,14153
"9f8068fd-f5cc-4e1a-946a-c9beb8b4d05a","cc2a8b56-732c-4e4c-a058-248783b68587","South Korea",489,1,1,1,0,2,5,656,94,289,0,1559,2598
"06026e76-f9a4-4fb9-877d-bcd33373cdab","cc2a8b56-732c-4e4c-a058-248783b68587","South Korea",489,3,6,6,5,7,27,647,730,1193,2142,3616,8328
"27e050a3-45e8-4076-9c25-32be9040da4e","cc2a8b56-732c-4e4c-a058-248783b68587","South Korea",489,3,3,1,2,2,11,662,1190,34,2137,765,4788
"4995f6d3-50ed-427d-9cf2-4ea0b81a229c","cc2a8b56-732c-4e4c-a058-248783b68587","South Korea",489,6,5,4,16,15,46,989,1141,1631,4223,7145,15129
"398e712a-fae6-451d-83c9-a7e500227e62","cc2a8b56-732c-4e4c-a058-248783b68587","South Korea",489,1,3,5,1,4,14,331,891,2212,756,821,5011
"65681129-f83c-4293-9ce3-9d1429367fd0","cc2a8b56-732c-4e4c-a058-248783b68587","South Korea",489,5,10,11,13,15,54,872,2071,6280,4964,3856,18043
"035a43cf-cf88-4675-85e7-11eeb0b3641c","cc2a8b56-732c-4e4c-a058-248783b68587","South Korea",489,10,13,8,10,17,58,2316,3980,4480,6105,11007,27888
"aaf1dbcb-3748-4740-a2e0-58e7c1cb9f78","cc2a8b56-732c-4e4c-a058-248783b68587","South Korea",489,4,3,3,3,3,16,1169,444,632,1973,2411,6629
"bf743fbf-9be2-49a1-bf7e-0b53276e6529","cc2a8b56-732c-4e4c-a058-248783b68587","South Korea",489,0,1,2,2,6,11,0,686,690,1634,4402,7412
"cd0a0a46-7676-4bf0-ad03-2e83bd565fee","cc2a8b56-732c-4e4c-a058-248783b68587","South Korea",489,2,6,2,3,6,19,436,1680,501,671,5496,8784
"9577727a-fa45-4185-9778-4a56a41cf0f6","cc2a8b56-732c-4e4c-a058-248783b68587","South Korea",489,2,2,2,1,3,10,335,435,1048,146,6807,8771
"073891b7-a928-4ff0-83e3-56f4d1a6315e","cc2a8b56-732c-4e4c-a058-248783b68587","South Korea",489,0,0,0,4,5,9,0,0,0,4771,6143,10914
"cc933e0b-091f-4ef4-bfc8-11f2076d4396","cc2a8b56-732c-4e4c-a058-248783b68587","South Korea",489,1,6,6,9,18,40,624,1659,2049,2505,12167,19004
"4ed0a862-3163-449b-bb48-ca8b9ce3add0","cc2a8b56-732c-4e4c-a058-248783b68587","South Korea",489,3,3,3,3,3,15,1421,1132,1089,754,2279,6675
"473d2e90-02dd-483e-ad19-3966ec20050a","cc2a8b56-732c-4e4c-a058-248783b68587","South Korea",489,0,2,3,2,4,11,0,797,709,1354,2654,5514
"03964ff9-d24f-4a0a-a492-3a177e16eb11","cc2a8b56-732c-4e4c-a058-248783b68587","South Korea",489,3,6,4,4,7,24,1183,2484,1549,2499,2984,10699
"e87291fb-8da5-4c7a-af30-4413737f2401","cc2a8b56-732c-4e4c-a058-248783b68587","South Korea",489,2,2,2,4,3,13,842,437,445,827,1943,4494
"915ec45f-204b-411d-8ed7-7fdecb385e39","cc2a8b56-732c-4e4c-a058-248783b68587","South Korea",489,6,9,5,17,21,58,1157,2176,2420,5668,10270,21691
"199d1269-1d8a-420a-a986-1f4f2ab4355f","dd13fcba-0ae1-43d3-9d32-1672ed84f151","USA",327,11,13,5,11,19,59,3257,3524,1857,5705,11631,25974
"fd0537e8-3103-47f8-9998-44570bb8a45e","dd13fcba-0ae1-43d3-9d32-1672ed84f151","USA",327,7,5,6,7,11,36,2132,471,1302,1269,4704,9878
"e433aa11-cdb7-4733-88a9-7067cf52299b","dd13fcba-0ae1-43d3-9d32-1672ed84f151","USA",327,2,1,1,2,5,11,292,413,329,1004,2656,4694
"149c1889-4e83-4153-b763-54fb60e60d99","dd13fcba-0ae1-43d3-9d32-1672ed84f151","USA",327,9,10,4,5,5,33,2848,2802,1087,1650,3293,11680
"14229a71-f44e-4149-9f3c-aa7415691eae","dd13fcba-0ae1-43d3-9d32-1672ed84f151","USA",327,6,15,3,9,25,58,1601,6109,1018,3703,13198,25629
"a724528f-7fe6-4ad6-bba1-21cb02db2af5","dd13fcba-0ae1-43d3-9d32-1672ed84f151","USA",327,6,8,3,4,10,31,1807,1304,1103,1696,4027,9937
"4f5ae77c-6112-401a-93d1-3bf44bd1ccbe","dd13fcba-0ae1-43d3-9d32-1672ed84f151","USA",327,1,2,1,1,3,8,425,426,31,586,1957,3425
"4f147d0e-54ac-4b89-a269-aaa7819fb0ef","dd13fcba-0ae1-43d3-9d32-1672ed84f151","USA",327,3,5,1,3,5,17,672,1099,318,977,4601,7667
"c464d108-c77f-41e7-bcbc-d5855c9a7968","dd13fcba-0ae1-43d3-9d32-1672ed84f151","USA",327,8,4,3,10,16,41,3626,691,1277,4717,8670,18981
"b20e7a20-ca68-410c-8214-fbb92bfdfe17","dd13fcba-0ae1-43d3-9d32-1672ed84f151","USA",327,3,5,2,3,6,19,1697,2057,350,1439,2608,8151
"131f7620-d15d-4560-86ab-564145745b9b","dd13fcba-0ae1-43d3-9d32-1672ed84f151","USA",327,2,6,0,4,9,21,817,2162,0,685,2253,5917
"131ecf76-b806-4557-b2c0-183a418357ba","dd13fcba-0ae1-43d3-9d32-1672ed84f151","USA",327,3,2,0,2,5,12,962,522,0,749,1644,3877
"9560482a-f0a3-4f68-a311-03d22aedbd05","dd13fcba-0ae1-43d3-9d32-1672ed84f151","USA",327,3,2,3,3,3,14,791,381,269,549,903,2893
"10e732f6-9a6a-474a-82e2-a4060fc8dffe","dd13fcba-0ae1-43d3-9d32-1672ed84f151","USA",327,3,3,3,4,4,17,778,816,1196,560,1861,5211
"646465ef-0ad6-44cc-bd31-de24e1487943","dd13fcba-0ae1-43d3-9d32-1672ed84f151","USA",327,10,25,14,4,18,71,3387,6848,4050,637,7983,22905
"aa2c1d96-ec88-4bcb-8d0e-e2b0c7632af1","dd13fcba-0ae1-43d3-9d32-1672ed84f151","USA",327,10,9,6,8,11,44,3290,1545,3158,2720,5428,16141
"9610f0dd-ff9f-4bd4-b311-459a04f965ca","dd13fcba-0ae1-43d3-9d32-1672ed84f151","USA",327,5,7,4,7,7,30,1993,1895,1195,1394,3029,9506
"df6523cd-3270-4298-8d6f-00aa8e9455e6","dd13fcba-0ae1-43d3-9d32-1672ed84f151","USA",327,3,8,12,1,5,29,671,2044,2667,206,1512,7100
"54c68134-2c2a-4f2e-974b-32310830af0e","dd13fcba-0ae1-43d3-9d32-1672ed84f151","USA",327,2,2,2,2,4,12,1299,1168,960,292,3688,7407
"055d198c-f8b0-47b7-9eb3-94fc57808f93","dd13fcba-0ae1-43d3-9d32-1672ed84f151","USA",327,3,2,2,2,5,14,928,503,1027,751,1003,4212
"cea293cd-b0b1-40ea-8e71-756b3956e8ad","dd13fcba-0ae1-43d3-9d32-1672ed84f151","USA",327,3,4,2,3,6,18,796,813,702,1473,3337,7121
"de86783a-ac86-419a-a230-dad6b421fba4","dd13fcba-0ae1-43d3-9d32-1672ed84f151","USA",327,2,0,4,5,8,19,999,0,1334,1485,4434,8252
"919c7921-7cef-4620-a2fe-766180ed2fbb","dd13fcba-0ae1-43d3-9d32-1672ed84f151","USA",327,5,11,12,6,13,47,1560,3008,4380,1821,8099,18868
"9f8068fd-f5cc-4e1a-946a-c9beb8b4d05a","dd13fcba-0ae1-43d3-9d32-1672ed84f151","USA",327,7,3,6,4,6,26,2233,998,1308,1216,2963,8718
"06026e76-f9a4-4fb9-877d-bcd33373cdab","dd13fcba-0ae1-43d3-9d32-1672ed84f151","USA",327,6,12,3,0,10,31,4390,3696,801,0,4309,13196
"27e050a3-45e8-4076-9c25-32be9040da4e","dd13fcba-0ae1-43d3-9d32-1672ed84f151","USA",327,1,4,5,0,16,26,687,1159,1650,0,8894,12390
"4995f6d3-50ed-427d-9cf2-4ea0b81a229c","dd13fcba-0ae1-43d3-9d32-1672ed84f151","USA",327,5,9,2,5,12,33,1538,2513,547,996,4862,10456
"398e712a-fae6-451d-83c9-a7e500227e62","dd13fcba-0ae1-43d3-9d32-1672ed84f151","USA",327,1,1,2,1,2,7,1093,191,177,140,745,2346
"65681129-f83c-4293-9ce3-9d1429367fd0","dd13fcba-0ae1-43d3-9d32-1672ed84f151","USA",327,10,11,8,8,7,44,1930,1586,1966,4457,2721,12660
"035a43cf-cf88-4675-85e7-11eeb0b3641c","dd13fcba-0ae1-43d3-9d32-1672ed84f151","USA",327,7,6,4,5,8,30,2206,1418,1259,1793,3970,10646
"aaf1dbcb-3748-4740-a2e0-58e7c1cb9f78","dd13fcba-0ae1-43d3-9d32-1672ed84f151","USA",327,2,4,2,4,3,15,402,482,352,1131,1768,4135
"bf743fbf-9be2-49a1-bf7e-0b53276e6529","dd13fcba-0ae1-43d3-9d32-1672ed84f151","USA",327,0,3,3,3,11,20,0,576,359,687,7085,8707
"cd0a0a46-7676-4bf0-ad03-2e83bd565fee","dd13fcba-0ae1-43d3-9d32-1672ed84f151","USA",327,1,3,1,3,5,13,365,841,357,640,4492,6695
"9577727a-fa45-4185-9778-4a56a41cf0f6","dd13fcba-0ae1-43d3-9d32-1672ed84f151","USA",327,2,4,2,1,3,12,659,1415,749,118,1814,4755
"073891b7-a928-4ff0-83e3-56f4d1a6315e","dd13fcba-0ae1-43d3-9d32-1672ed84f151","USA",327,0,2,1,6,13,22,0,566,209,2621,12665,16061
"cc933e0b-091f-4ef4-bfc8-11f2076d4396","dd13fcba-0ae1-43d3-9d32-1672ed84f151","USA",327,4,9,3,8,13,37,1136,2466,328,2571,5868,12369
"4ed0a862-3163-449b-bb48-ca8b9ce3add0","dd13fcba-0ae1-43d3-9d32-1672ed84f151","USA",327,4,5,4,5,13,31,954,621,1343,3140,6934,12992
"473d2e90-02dd-483e-ad19-3966ec20050a","dd13fcba-0ae1-43d3-9d32-1672ed84f151","USA",327,6,4,3,0,3,16,1360,1651,669,0,1711,5391
"03964ff9-d24f-4a0a-a492-3a177e16eb11","dd13fcba-0ae1-43d3-9d32-1672ed84f151","USA",327,2,1,1,2,3,9,390,564,315,445,2238,3952
"e87291fb-8da5-4c7a-af30-4413737f2401","dd13fcba-0ae1-43d3-9d32-1672ed84f151","USA",327,7,2,2,4,4,19,1499,519,858,1315,2767,6958
"915ec45f-204b-411d-8ed7-7fdecb385e39","dd13fcba-0ae1-43d3-9d32-1672ed84f151","USA",327,7,3,4,8,12,34,2377,508,964,2342,4505,10696
"199d1269-1d8a-420a-a986-1f4f2ab4355f","6afda059-04a5-4308-b776-a532ed142284","Italy",238,7,12,2,7,13,41,1307,4426,434,2002,8239,16408
"fd0537e8-3103-47f8-9998-44570bb8a45e","6afda059-04a5-4308-b776-a532ed142284","Italy",238,6,7,2,10,7,32,4238,1885,419,1362,4546,12450
"e433aa11-cdb7-4733-88a9-7067cf52299b","6afda059-04a5-4308-b776-a532ed142284","Italy",238,6,12,4,4,10,36,2203,6181,1108,901,3956,14349
"149c1889-4e83-4153-b763-54fb60e60d99","6afda059-04a5-4308-b776-a532ed142284","Italy",238,2,5,2,5,4,18,339,1338,540,1448,6626,10291
"14229a71-f44e-4149-9f3c-aa7415691eae","6afda059-04a5-4308-b776-a532ed142284","Italy",238,4,3,2,4,7,20,871,1633,1533,2090,4577,10704
"a724528f-7fe6-4ad6-bba1-21cb02db2af5","6afda059-04a5-4308-b776-a532ed142284","Italy",238,5,8,4,8,12,37,1471,3410,2190,4524,15297,26892
"4f5ae77c-6112-401a-93d1-3bf44bd1ccbe","6afda059-04a5-4308-b776-a532ed142284","Italy",238,2,3,3,2,2,12,1582,595,197,791,1601,4766
"4f147d0e-54ac-4b89-a269-aaa7819fb0ef","6afda059-04a5-4308-b776-a532ed142284","Italy",238,3,4,2,3,4,16,826,1762,209,1028,6598,10423
"c464d108-c77f-41e7-bcbc-d5855c9a7968","6afda059-04a5-4308-b776-a532ed142284","Italy",238,6,10,7,8,15,46,4159,2772,2794,2130,5734,17589
"b20e7a20-ca68-410c-8214-fbb92bfdfe17","6afda059-04a5-4308-b776-a532ed142284","Italy",238,3,2,2,2,4,13,928,1178,416,1299,2051,5872
"131f7620-d15d-4560-86ab-564145745b9b","6afda059-04a5-4308-b776-a532ed142284","Italy",238,0,5,10,6,18,39,0,2466,4803,2452,7123,16844
"131ecf76-b806-4557-b2c0-183a418357ba","6afda059-04a5-4308-b776-a532ed142284","Italy",238,2,3,2,2,4,13,699,1442,1436,909,2192,6678
"9560482a-f0a3-4f68-a311-03d22aedbd05","6afda059-04a5-4308-b776-a532ed142284","Italy",238,3,3,3,3,4,16,635,555,218,517,2409,4334
"10e732f6-9a6a-474a-82e2-a4060fc8dffe","6afda059-04a5-4308-b776-a532ed142284","Italy",238,9,16,9,7,12,53,4070,4519,3032,2167,9547,23335
"646465ef-0ad6-44cc-bd31-de24e1487943","6afda059-04a5-4308-b776-a532ed142284","Italy",238,4,6,3,7,13,33,665,2164,962,1963,12159,17913
"aa2c1d96-ec88-4bcb-8d0e-e2b0c7632af1","6afda059-04a5-4308-b776-a532ed142284","Italy",238,3,6,5,4,9,27,1425,1116,1264,1820,3135,8760
"9610f0dd-ff9f-4bd4-b311-459a04f965ca","6afda059-04a5-4308-b776-a532ed142284","Italy",238,5,3,4,11,13,36,1216,975,575,1972,5562,10300
"df6523cd-3270-4298-8d6f-00aa8e9455e6","6afda059-04a5-4308-b776-a532ed142284","Italy",238,8,13,10,3,8,42,3121,4350,2373,2047,3859,15750
"54c68134-2c2a-4f2e-974b-32310830af0e","6afda059-04a5-4308-b776-a532ed142284","Italy",238,8,9,4,8,8,37,3270,4344,1684,3056,8396,20750
"055d198c-f8b0-47b7-9eb3-94fc57808f93","6afda059-04a5-4308-b776-a532ed142284","Italy",238,11,10,7,5,9,42,5323,5418,3683,2451,9491,26366
"cea293cd-b0b1-40ea-8e71-756b3956e8ad","6afda059-04a5-4308-b776-a532ed142284","Italy",238,5,8,4,2,4,23,1393,2210,639,715,1436,6393
"de86783a-ac86-419a-a230-dad6b421fba4","6afda059-04a5-4308-b776-a532ed142284","Italy",238,2,3,1,4,6,16,859,2961,433,1030,3386,8669
"919c7921-7cef-4620-a2fe-766180ed2fbb","6afda059-04a5-4308-b776-a532ed142284","Italy",238,1,3,2,2,5,13,329,720,1425,757,4782,8013
"9f8068fd-f5cc-4e1a-946a-c9beb8b4d05a","6afda059-04a5-4308-b776-a532ed142284","Italy",238,3,3,4,3,4,17,1239,1699,805,1186,1835,6764
"06026e76-f9a4-4fb9-877d-bcd33373cdab","6afda059-04a5-4308-b776-a532ed142284","Italy",238,2,0,1,13,13,29,306,0,330,2936,5621,9193
"27e050a3-45e8-4076-9c25-32be9040da4e","6afda059-04a5-4308-b776-a532ed142284","Italy",238,1,5,4,1,8,19,734,2196,1582,234,4662,9408
"4995f6d3-50ed-427d-9cf2-4ea0b81a229c","6afda059-04a5-4308-b776-a532ed142284","Italy",238,7,6,4,5,7,29,2391,1478,1050,1429,4454,10802
"398e712a-fae6-451d-83c9-a7e500227e62","6afda059-04a5-4308-b776-a532ed142284","Italy",238,2,3,2,1,2,10,678,868,1224,184,348,3302
"65681129-f83c-4293-9ce3-9d1429367fd0","6afda059-04a5-4308-b776-a532ed142284","Italy",238,11,18,7,6,11,53,2061,3236,1914,1956,5210,14377
"035a43cf-cf88-4675-85e7-11eeb0b3641c","6afda059-04a5-4308-b776-a532ed142284","Italy",238,8,7,4,4,5,28,1821,2236,1202,677,2853,8789
"aaf1dbcb-3748-4740-a2e0-58e7c1cb9f78","6afda059-04a5-4308-b776-a532ed142284","Italy",238,3,10,4,9,12,38,1335,2381,929,3346,5344,13335
"bf743fbf-9be2-49a1-bf7e-0b53276e6529","6afda059-04a5-4308-b776-a532ed142284","Italy",238,6,7,1,12,10,36,1062,3640,328,7808,6068,18906
"cd0a0a46-7676-4bf0-ad03-2e83bd565fee","6afda059-04a5-4308-b776-a532ed142284","Italy",238,5,8,6,2,8,29,2903,3829,1677,338,5373,14120
"9577727a-fa45-4185-9778-4a56a41cf0f6","6afda059-04a5-4308-b776-a532ed142284","Italy",238,2,3,0,1,4,10,676,1583,0,669,1587,4515
"073891b7-a928-4ff0-83e3-56f4d1a6315e","6afda059-04a5-4308-b776-a532ed142284","Italy",238,4,4,4,4,7,23,1149,3019,2331,3299,2278,12076
"cc933e0b-091f-4ef4-bfc8-11f2076d4396","6afda059-04a5-4308-b776-a532ed142284","Italy",238,10,10,5,11,12,48,4207,3049,1278,3781,9152,21467
"4ed0a862-3163-449b-bb48-ca8b9ce3add0","6afda059-04a5-4308-b776-a532ed142284","Italy",238,1,6,4,4,10,25,385,1447,1392,2102,5391,10717
"473d2e90-02dd-483e-ad19-3966ec20050a","6afda059-04a5-4308-b776-a532ed142284","Italy",238,2,3,2,4,6,17,867,1763,620,1111,3844,8205
"03964ff9-d24f-4a0a-a492-3a177e16eb11","6afda059-04a5-4308-b776-a532ed142284","Italy",238,1,4,4,2,5,16,505,2294,1393,374,1529,6095
"e87291fb-8da5-4c7a-af30-4413737f2401","6afda059-04a5-4308-b776-a532ed142284","Italy",238,2,6,1,1,5,15,594,1820,34,532,2915,5895
"915ec45f-204b-411d-8ed7-7fdecb385e39","6afda059-04a5-4308-b776-a532ed142284","Italy",238,5,8,7,9,17,46,789,2361,2046,5093,6251,16540
"199d1269-1d8a-420a-a986-1f4f2ab4355f","f61f9030-d814-495d-af95-0e643697de64","Brazil",352,4,12,6,14,13,49,1608,4260,2585,6889,5941,21283
"fd0537e8-3103-47f8-9998-44570bb8a45e","f61f9030-d814-495d-af95-0e643697de64","Brazil",352,3,7,3,18,15,46,571,4551,531,2944,7305,15902
"e433aa11-cdb7-4733-88a9-7067cf52299b","f61f9030-d814-495d-af95-0e643697de64","Brazil",352,4,13,2,13,17,49,848,6294,1218,4793,9032,22185
"149c1889-4e83-4153-b763-54fb60e60d99","f61f9030-d814-495d-af95-0e643697de64","Brazil",352,0,5,3,8,11,27,0,3098,826,4134,6062,14120
"14229a71-f44e-4149-9f3c-aa7415691eae","f61f9030-d814-495d-af95-0e643697de64","Brazil",352,3,10,7,5,10,35,1534,3560,3836,4499,4268,17697
"a724528f-7fe6-4ad6-bba1-21cb02db2af5","f61f9030-d814-495d-af95-0e643697de64","Brazil",352,4,14,9,4,16,47,2672,5388,3173,6503,8525,26261
"4f5ae77c-6112-401a-93d1-3bf44bd1ccbe","f61f9030-d814-495d-af95-0e643697de64","Brazil",352,1,3,1,2,3,10,51,1052,1015,1618,1177,4913
"4f147d0e-54ac-4b89-a269-aaa7819fb0ef","f61f9030-d814-495d-af95-0e643697de64","Brazil",352,2,6,2,5,5,20,836,1883,498,1967,1734,6918
"c464d108-c77f-41e7-bcbc-d5855c9a7968","f61f9030-d814-495d-af95-0e643697de64","Brazil",352,7,14,7,12,9,49,1796,5027,3629,4236,2701,17389
"b20e7a20-ca68-410c-8214-fbb92bfdfe17","f61f9030-d814-495d-af95-0e643697de64","Brazil",352,3,5,2,3,1,14,1328,1703,1069,1920,1117,7137
"131f7620-d15d-4560-86ab-564145745b9b","f61f9030-d814-495d-af95-0e643697de64","Brazil",352,3,12,4,13,16,48,631,5125,2160,5185,10377,23478
"131ecf76-b806-4557-b2c0-183a418357ba","f61f9030-d814-495d-af95-0e643697de64","Brazil",352,1,3,2,3,2,11,188,1797,982,1971,1671,6609
"9560482a-f0a3-4f68-a311-03d22aedbd05","f61f9030-d814-495d-af95-0e643697de64","Brazil",352,1,2,1,4,3,11,528,312,1063,1108,1546,4557
"10e732f6-9a6a-474a-82e2-a4060fc8dffe","f61f9030-d814-495d-af95-0e643697de64","Brazil",352,8,15,15,12,16,66,2927,4241,6903,4654,7605,26330
"646465ef-0ad6-44cc-bd31-de24e1487943","f61f9030-d814-495d-af95-0e643697de64","Brazil",352,4,18,7,10,12,51,1439,6576,2322,7393,5477,23207
"aa2c1d96-ec88-4bcb-8d0e-e2b0c7632af1","f61f9030-d814-495d-af95-0e643697de64","Brazil",352,8,8,4,8,7,35,1820,2677,1839,2451,3050,11837
"9610f0dd-ff9f-4bd4-b311-459a04f965ca","f61f9030-d814-495d-af95-0e643697de64","Brazil",352,3,6,2,6,8,25,916,1377,855,2687,4172,10007
"df6523cd-3270-4298-8d6f-00aa8e9455e6","f61f9030-d814-495d-af95-0e643697de64","Brazil",352,0,10,8,5,7,30,0,4844,4043,2288,2118,13293
"54c68134-2c2a-4f2e-974b-32310830af0e","f61f9030-d814-495d-af95-0e643697de64","Brazil",352,1,3,2,4,5,15,179,400,338,1362,4182,6461
"055d198c-f8b0-47b7-9eb3-94fc57808f93","f61f9030-d814-495d-af95-0e643697de64","Brazil",352,10,13,9,12,12,56,2799,5176,4418,5100,5007,22500
"cea293cd-b0b1-40ea-8e71-756b3956e8ad","f61f9030-d814-495d-af95-0e643697de64","Brazil",352,1,9,7,3,5,25,313,2681,3185,1444,4802,12425
"de86783a-ac86-419a-a230-dad6b421fba4","f61f9030-d814-495d-af95-0e643697de64","Brazil",352,6,10,5,6,8,35,1211,2632,1345,2843,3490,11521
"919c7921-7cef-4620-a2fe-766180ed2fbb","f61f9030-d814-495d-af95-0e643697de64","Brazil",352,5,6,2,7,6,26,1437,1483,1913,2094,4408,11335
"9f8068fd-f5cc-4e1a-946a-c9beb8b4d05a","f61f9030-d814-495d-af95-0e643697de64","Brazil",352,2,4,3,3,3,15,785,1497,922,1273,1950,6427
"06026e76-f9a4-4fb9-877d-bcd33373cdab","f61f9030-d814-495d-af95-0e643697de64","Brazil",352,1,1,1,10,11,24,190,325,115,4129,6839,11598
"27e050a3-45e8-4076-9c25-32be9040da4e","f61f9030-d814-495d-af95-0e643697de64","Brazil",352,0,5,2,4,11,22,0,4998,438,1708,7161,14305
"4995f6d3-50ed-427d-9cf2-4ea0b81a229c","f61f9030-d814-495d-af95-0e643697de64","Brazil",352,5,7,5,10,11,38,1418,1236,2638,1833,5371,12496
"398e712a-fae6-451d-83c9-a7e500227e62","f61f9030-d814-495d-af95-0e643697de64","Brazil",352,5,9,3,6,2,25,628,3229,2817,2329,317,9320
"65681129-f83c-4293-9ce3-9d1429367fd0","f61f9030-d814-495d-af95-0e643697de64","Brazil",352,4,12,5,6,7,34,2069,3623,1776,2904,3073,13445
"035a43cf-cf88-4675-85e7-11eeb0b3641c","f61f9030-d814-495d-af95-0e643697de64","Brazil",352,4,14,10,7,11,46,2213,6222,9289,4509,7227,29460
"aaf1dbcb-3748-4740-a2e0-58e7c1cb9f78","f61f9030-d814-495d-af95-0e643697de64","Brazil",352,4,8,9,10,15,46,1427,1963,4017,2651,4787,14845
"bf743fbf-9be2-49a1-bf7e-0b53276e6529","f61f9030-d814-495d-af95-0e643697de64","Brazil",352,0,2,5,2,7,16,0,1682,3092,889,4635,10298
"cd0a0a46-7676-4bf0-ad03-2e83bd565fee","f61f9030-d814-495d-af95-0e643697de64","Brazil",352,1,8,4,3,6,22,660,3915,2756,1997,4744,14072
"9577727a-fa45-4185-9778-4a56a41cf0f6","f61f9030-d814-495d-af95-0e643697de64","Brazil",352,1,4,2,1,2,10,450,1275,2024,830,1582,6161
"073891b7-a928-4ff0-83e3-56f4d1a6315e","f61f9030-d814-495d-af95-0e643697de64","Brazil",352,0,3,2,3,3,11,0,2080,850,2449,2458,7837
"cc933e0b-091f-4ef4-bfc8-11f2076d4396","f61f9030-d814-495d-af95-0e643697de64","Brazil",352,3,11,7,4,8,33,1254,5920,2089,1700,3794,14757
"4ed0a862-3163-449b-bb48-ca8b9ce3add0","f61f9030-d814-495d-af95-0e643697de64","Brazil",352,3,10,7,13,20,53,593,2196,1114,5298,7362,16563
"473d2e90-02dd-483e-ad19-3966ec20050a","f61f9030-d814-495d-af95-0e643697de64","Brazil",352,2,4,4,4,5,19,94,1154,833,1135,2846,6062
"03964ff9-d24f-4a0a-a492-3a177e16eb11","f61f9030-d814-495d-af95-0e643697de64","Brazil",352,1,3,2,1,4,11,583,2582,1935,274,2244,7618
"e87291fb-8da5-4c7a-af30-4413737f2401","f61f9030-d814-495d-af95-0e643697de64","Brazil",352,2,4,5,2,5,18,1303,1124,1054,1175,1757,6413
"915ec45f-204b-411d-8ed7-7fdecb385e39","f61f9030-d814-495d-af95-0e643697de64","Brazil",352,2,7,8,7,14,38,372,2282,3987,2829,10578,20048
"199d1269-1d8a-420a-a986-1f4f2ab4355f","5445f170-12c1-48fc-9563-3709dd2993b0","Greece",980,3,8,1,2,4,18,1145,5076,338,595,2012,9166
"fd0537e8-3103-47f8-9998-44570bb8a45e","5445f170-12c1-48fc-9563-3709dd2993b0","Greece",980,3,7,2,1,9,22,1148,1987,585,28,5791,9539
"e433aa11-cdb7-4733-88a9-7067cf52299b","5445f170-12c1-48fc-9563-3709dd2993b0","Greece",980,0,2,2,17,14,35,0,356,1017,7794,7093,16260
"149c1889-4e83-4153-b763-54fb60e60d99","5445f170-12c1-48fc-9563-3709dd2993b0","Greece",980,2,4,2,1,5,14,834,1150,717,612,2066,5379
"14229a71-f44e-4149-9f3c-aa7415691eae","5445f170-12c1-48fc-9563-3709dd2993b0","Greece",980,2,7,6,6,13,34,1475,1697,953,2151,6311,12587
"a724528f-7fe6-4ad6-bba1-21cb02db2af5","5445f170-12c1-48fc-9563-3709dd2993b0","Greece",980,3,12,12,7,27,61,1127,3322,2138,1611,11942,20140
"4f5ae77c-6112-401a-93d1-3bf44bd1ccbe","5445f170-12c1-48fc-9563-3709dd2993b0","Greece",980,3,3,3,1,4,14,318,611,617,618,2077,4241
"4f147d0e-54ac-4b89-a269-aaa7819fb0ef","5445f170-12c1-48fc-9563-3709dd2993b0","Greece",980,1,4,3,1,4,13,815,2413,1021,413,2034,6696
"c464d108-c77f-41e7-bcbc-d5855c9a7968","5445f170-12c1-48fc-9563-3709dd2993b0","Greece",980,7,3,3,11,10,34,4143,1261,870,4588,5480,16342
"b20e7a20-ca68-410c-8214-fbb92bfdfe17","5445f170-12c1-48fc-9563-3709dd2993b0","Greece",980,1,1,0,7,1,10,466,99,0,1535,44,2144
"131f7620-d15d-4560-86ab-564145745b9b","5445f170-12c1-48fc-9563-3709dd2993b0","Greece",980,1,6,5,3,14,29,178,1622,2716,1318,11452,17286
"131ecf76-b806-4557-b2c0-183a418357ba","5445f170-12c1-48fc-9563-3709dd2993b0","Greece",980,1,1,1,2,3,8,473,1020,395,454,1057,3399
"9560482a-f0a3-4f68-a311-03d22aedbd05","5445f170-12c1-48fc-9563-3709dd2993b0","Greece",980,3,3,5,2,4,17,776,1074,1161,766,2193,5970
"10e732f6-9a6a-474a-82e2-a4060fc8dffe","5445f170-12c1-48fc-9563-3709dd2993b0","Greece",980,7,9,9,4,6,35,2954,3547,1284,941,6332,15058
"646465ef-0ad6-44cc-bd31-de24e1487943","5445f170-12c1-48fc-9563-3709dd2993b0","Greece",980,7,15,5,3,12,42,2578,4018,802,375,10302,18075
"aa2c1d96-ec88-4bcb-8d0e-e2b0c7632af1","5445f170-12c1-48fc-9563-3709dd2993b0","Greece",980,5,5,3,5,5,23,677,854,756,890,1881,5058
"9610f0dd-ff9f-4bd4-b311-459a04f965ca","5445f170-12c1-48fc-9563-3709dd2993b0","Greece",980,3,7,4,3,10,27,933,1899,664,1375,3605,8476
"df6523cd-3270-4298-8d6f-00aa8e9455e6","5445f170-12c1-48fc-9563-3709dd2993b0","Greece",980,5,11,13,7,20,56,1714,3198,3953,2369,6976,18210
"54c68134-2c2a-4f2e-974b-32310830af0e","5445f170-12c1-48fc-9563-3709dd2993b0","Greece",980,6,6,4,4,6,26,3649,1143,1107,3015,7249,16163
"055d198c-f8b0-47b7-9eb3-94fc57808f93","5445f170-12c1-48fc-9563-3709dd2993b0","Greece",980,5,6,6,10,9,36,1714,2035,1334,4590,8580,18253
"cea293cd-b0b1-40ea-8e71-756b3956e8ad","5445f170-12c1-48fc-9563-3709dd2993b0","Greece",980,3,12,6,2,7,30,1786,2775,1604,695,4490,11350
"de86783a-ac86-419a-a230-dad6b421fba4","5445f170-12c1-48fc-9563-3709dd2993b0","Greece",980,2,4,3,5,6,20,599,1535,98,1132,4317,7681
"919c7921-7cef-4620-a2fe-766180ed2fbb","5445f170-12c1-48fc-9563-3709dd2993b0","Greece",980,2,2,1,6,6,17,556,1505,31,3017,1843,6952
"9f8068fd-f5cc-4e1a-946a-c9beb8b4d05a","5445f170-12c1-48fc-9563-3709dd2993b0","Greece",980,6,9,6,10,13,44,1398,1389,1390,1567,4327,10071
"06026e76-f9a4-4fb9-877d-bcd33373cdab","5445f170-12c1-48fc-9563-3709dd2993b0","Greece",980,1,3,1,13,13,31,254,777,251,6038,9353,16673
"27e050a3-45e8-4076-9c25-32be9040da4e","5445f170-12c1-48fc-9563-3709dd2993b0","Greece",980,1,8,5,1,11,26,196,4168,680,245,6380,11669
"4995f6d3-50ed-427d-9cf2-4ea0b81a229c","5445f170-12c1-48fc-9563-3709dd2993b0","Greece",980,6,8,5,4,9,32,1152,3314,1010,1395,4981,11852
"398e712a-fae6-451d-83c9-a7e500227e62","5445f170-12c1-48fc-9563-3709dd2993b0","Greece",980,5,5,2,6,5,23,1033,2081,834,930,1750,6628
"65681129-f83c-4293-9ce3-9d1429367fd0","5445f170-12c1-48fc-9563-3709dd2993b0","Greece",980,3,12,9,2,9,35,1604,2258,1528,951,3674,10015
"035a43cf-cf88-4675-85e7-11eeb0b3641c","5445f170-12c1-48fc-9563-3709dd2993b0","Greece",980,7,9,10,5,12,43,1126,3983,3781,2095,9168,20153
"aaf1dbcb-3748-4740-a2e0-58e7c1cb9f78","5445f170-12c1-48fc-9563-3709dd2993b0","Greece",980,7,4,6,6,10,33,2281,1380,684,1448,3788,9581
"bf743fbf-9be2-49a1-bf7e-0b53276e6529","5445f170-12c1-48fc-9563-3709dd2993b0","Greece",980,1,5,2,4,2,14,61,1744,234,1008,1528,4575
"cd0a0a46-7676-4bf0-ad03-2e83bd565fee","5445f170-12c1-48fc-9563-3709dd2993b0","Greece",980,3,5,8,3,7,26,1610,1239,1942,1025,6537,12353
"9577727a-fa45-4185-9778-4a56a41cf0f6","5445f170-12c1-48fc-9563-3709dd2993b0","Greece",980,1,2,1,0,2,6,352,342,312,0,188,1194
"073891b7-a928-4ff0-83e3-56f4d1a6315e","5445f170-12c1-48fc-9563-3709dd2993b0","Greece",980,0,2,2,0,5,9,0,749,1397,0,3982,6128
"cc933e0b-091f-4ef4-bfc8-11f2076d4396","5445f170-12c1-48fc-9563-3709dd2993b0","Greece",980,6,15,5,11,14,51,1886,5806,936,2918,5508,17054
"4ed0a862-3163-449b-bb48-ca8b9ce3add0","5445f170-12c1-48fc-9563-3709dd2993b0","Greece",980,1,2,2,7,15,27,631,140,156,2048,8512,11487
"473d2e90-02dd-483e-ad19-3966ec20050a","5445f170-12c1-48fc-9563-3709dd2993b0","Greece",980,5,4,2,2,6,19,2143,907,787,1077,4353,9267
"03964ff9-d24f-4a0a-a492-3a177e16eb11","5445f170-12c1-48fc-9563-3709dd2993b0","Greece",980,2,4,2,2,6,16,896,1362,2473,1086,2786,8603
"e87291fb-8da5-4c7a-af30-4413737f2401","5445f170-12c1-48fc-9563-3709dd2993b0","Greece",980,3,4,3,3,5,18,1337,1159,913,1114,1945,6468
"915ec45f-204b-411d-8ed7-7fdecb385e39","5445f170-12c1-48fc-9563-3709dd2993b0","Greece",980,5,11,10,19,21,66,1905,3120,2086,6717,12917,26745
"38c90b27-ea8c-4111-a922-4e81390fefab","34359006-f70f-438e-85d0-420cf2fe6944","Ukraine",156,2,5,2,2,2,13,1439,1085,380,632,1102,4638
"4436282c-7d0f-4334-ba8d-80b7cfe2b849","34359006-f70f-438e-85d0-420cf2fe6944","Ukraine",156,1,1,3,1,3,9,868,537,1280,383,428,3496
"98a2ab99-afcb-447e-ae8d-4b96b374e4d7","34359006-f70f-438e-85d0-420cf2fe6944","Ukraine",156,8,4,2,6,4,24,2166,492,624,2390,3930,9602
"6caef30c-9e58-4bd8-bf6a-e3dcac4256f1","34359006-f70f-438e-85d0-420cf2fe6944","Ukraine",156,1,2,0,3,2,8,446,351,0,3213,1268,5278
"c19419a4-de5b-4642-b925-120bf7999f25","34359006-f70f-438e-85d0-420cf2fe6944","Ukraine",156,4,9,6,3,6,28,1137,2328,1484,1691,2811,9451
"0cd83ffd-f258-4775-a358-c55074060d88","34359006-f70f-438e-85d0-420cf2fe6944","Ukraine",156,13,11,2,14,9,49,3089,1807,605,3573,2976,12050
"5b5b9eb7-f06a-48a3-b3e8-675a7f2faf18","34359006-f70f-438e-85d0-420cf2fe6944","Ukraine",156,1,2,2,2,3,10,91,648,504,215,1696,3154
"38c90b27-ea8c-4111-a922-4e81390fefab","20f3c152-6ebf-49db-8e1a-00eebd99feb6","Finland",672,9,3,7,5,3,27,4849,1031,1697,2009,1149,10735
"4436282c-7d0f-4334-ba8d-80b7cfe2b849","20f3c152-6ebf-49db-8e1a-00eebd99feb6","Finland",672,3,2,3,6,4,18,1638,593,1090,1247,1474,6042
"98a2ab99-afcb-447e-ae8d-4b96b374e4d7","20f3c152-6ebf-49db-8e1a-00eebd99feb6","Finland",672,4,3,2,5,1,15,2153,1709,836,1420,368,6486
"6caef30c-9e58-4bd8-bf6a-e3dcac4256f1","20f3c152-6ebf-49db-8e1a-00eebd99feb6","Finland",672,1,1,2,5,1,10,516,714,507,1559,174,3470
"c19419a4-de5b-4642-b925-120bf7999f25","20f3c152-6ebf-49db-8e1a-00eebd99feb6","Finland",672,7,6,6,8,6,33,4063,2989,1529,1654,4840,15075
"0cd83ffd-f258-4775-a358-c55074060d88","20f3c152-6ebf-49db-8e1a-00eebd99feb6","Finland",672,8,7,6,12,7,40,2857,3918,1722,1881,1969,12347
"5b5b9eb7-f06a-48a3-b3e8-675a7f2faf18","20f3c152-6ebf-49db-8e1a-00eebd99feb6","Finland",672,3,4,3,3,2,15,1526,974,285,445,776,4006
"38c90b27-ea8c-4111-a922-4e81390fefab","213479f7-39af-4b83-b0e9-4ba473d27429","Spain",756,4,3,1,4,4,16,1555,625,758,1884,1593,6415
"4436282c-7d0f-4334-ba8d-80b7cfe2b849","213479f7-39af-4b83-b0e9-4ba473d27429","Spain",756,2,4,5,3,5,19,422,892,1403,948,3047,6712
"98a2ab99-afcb-447e-ae8d-4b96b374e4d7","213479f7-39af-4b83-b0e9-4ba473d27429","Spain",756,1,5,5,5,11,27,1392,1270,1756,2293,2878,9589
"6caef30c-9e58-4bd8-bf6a-e3dcac4256f1","213479f7-39af-4b83-b0e9-4ba473d27429","Spain",756,1,2,2,2,4,11,123,192,794,250,1045,2404
"c19419a4-de5b-4642-b925-120bf7999f25","213479f7-39af-4b83-b0e9-4ba473d27429","Spain",756,3,8,5,5,7,28,751,1566,1767,1178,3936,9198
"0cd83ffd-f258-4775-a358-c55074060d88","213479f7-39af-4b83-b0e9-4ba473d27429","Spain",756,9,17,17,10,24,77,2015,3310,5429,2315,9475,22544
"5b5b9eb7-f06a-48a3-b3e8-675a7f2faf18","213479f7-39af-4b83-b0e9-4ba473d27429","Spain",756,2,4,2,5,4,17,213,1408,589,1187,1333,4730
"38c90b27-ea8c-4111-a922-4e81390fefab","7bdf6ed6-acf9-4a7b-84fe-7e4f96f9582a","France",421,8,9,6,10,5,38,4417,3565,1545,5470,2064,17061
"4436282c-7d0f-4334-ba8d-80b7cfe2b849","7bdf6ed6-acf9-4a7b-84fe-7e4f96f9582a","France",421,0,1,1,5,4,11,0,373,340,1873,541,3127
"98a2ab99-afcb-447e-ae8d-4b96b374e4d7","7bdf6ed6-acf9-4a7b-84fe-7e4f96f9582a","France",421,2,5,3,10,1,21,585,1415,955,2499,30,5484
"6caef30c-9e58-4bd8-bf6a-e3dcac4256f1","7bdf6ed6-acf9-4a7b-84fe-7e4f96f9582a","France",421,1,4,3,6,1,15,267,954,1024,3211,114,5570
"c19419a4-de5b-4642-b925-120bf7999f25","7bdf6ed6-acf9-4a7b-84fe-7e4f96f9582a","France",421,3,5,1,9,4,22,434,1778,362,5133,1135,8842
"0cd83ffd-f258-4775-a358-c55074060d88","7bdf6ed6-acf9-4a7b-84fe-7e4f96f9582a","France",421,2,4,3,9,4,22,231,1803,361,4396,650,7441
"5b5b9eb7-f06a-48a3-b3e8-675a7f2faf18","7bdf6ed6-acf9-4a7b-84fe-7e4f96f9582a","France",421,0,1,2,5,2,10,0,108,447,2174,255,2984
"38c90b27-ea8c-4111-a922-4e81390fefab","cc2a8b56-732c-4e4c-a058-248783b68587","South Korea",489,1,3,1,3,6,14,93,702,377,2836,3598,7606
"4436282c-7d0f-4334-ba8d-80b7cfe2b849","cc2a8b56-732c-4e4c-a058-248783b68587","South Korea",489,0,1,2,5,4,12,0,34,197,1067,2551,3849
"98a2ab99-afcb-447e-ae8d-4b96b374e4d7","cc2a8b56-732c-4e4c-a058-248783b68587","South Korea",489,2,3,4,3,11,23,685,1241,2885,522,4504,9837
"6caef30c-9e58-4bd8-bf6a-e3dcac4256f1","cc2a8b56-732c-4e4c-a058-248783b68587","South Korea",489,0,1,0,6,9,16,0,15,0,2252,4107,6374
"c19419a4-de5b-4642-b925-120bf7999f25","cc2a8b56-732c-4e4c-a058-248783b68587","South Korea",489,2,2,2,5,6,17,426,659,738,2854,4652,9329
"0cd83ffd-f258-4775-a358-c55074060d88","cc2a8b56-732c-4e4c-a058-248783b68587","South Korea",489,2,6,10,4,10,32,350,1038,3003,1508,3679,9578
"5b5b9eb7-f06a-48a3-b3e8-675a7f2faf18","cc2a8b56-732c-4e4c-a058-248783b68587","South Korea",489,2,4,6,1,10,23,318,532,3096,129,5133,9208
"38c90b27-ea8c-4111-a922-4e81390fefab","dd13fcba-0ae1-43d3-9d32-1672ed84f151","USA",327,4,4,0,5,3,16,3110,621,0,1239,1405,6375
"4436282c-7d0f-4334-ba8d-80b7cfe2b849","dd13fcba-0ae1-43d3-9d32-1672ed84f151","USA",327,2,3,1,2,6,14,628,850,318,643,1976,4415
"98a2ab99-afcb-447e-ae8d-4b96b374e4d7","dd13fcba-0ae1-43d3-9d32-1672ed84f151","USA",327,4,5,5,4,8,26,1166,979,522,954,2001,5622
"6caef30c-9e58-4bd8-bf6a-e3dcac4256f1","dd13fcba-0ae1-43d3-9d32-1672ed84f151","USA",327,0,6,3,0,5,14,0,1344,847,0,4828,7019
"c19419a4-de5b-4642-b925-120bf7999f25","dd13fcba-0ae1-43d3-9d32-1672ed84f151","USA",327,9,15,5,7,17,53,2770,2139,2164,3947,9596,20616
"0cd83ffd-f258-4775-a358-c55074060d88","dd13fcba-0ae1-43d3-9d32-1672ed84f151","USA",327,1,3,2,5,17,28,441,758,414,842,10136,12591
"5b5b9eb7-f06a-48a3-b3e8-675a7f2faf18","dd13fcba-0ae1-43d3-9d32-1672ed84f151","USA",327,0,1,2,0,4,7,0,237,406,0,945,1588
"38c90b27-ea8c-4111-a922-4e81390fefab","6afda059-04a5-4308-b776-a532ed142284","Italy",238,4,4,1,3,4,16,1116,1565,49,1047,2167,5944
"4436282c-7d0f-4334-ba8d-80b7cfe2b849","6afda059-04a5-4308-b776-a532ed142284","Italy",238,1,2,1,1,2,7,230,499,239,218,1424,2610
"98a2ab99-afcb-447e-ae8d-4b96b374e4d7","6afda059-04a5-4308-b776-a532ed142284","Italy",238,1,8,8,3,14,34,319,2971,2509,636,7589,14024
"6caef30c-9e58-4bd8-bf6a-e3dcac4256f1","6afda059-04a5-4308-b776-a532ed142284","Italy",238,2,2,3,1,3,11,605,176,1597,306,3798,6482
"c19419a4-de5b-4642-b925-120bf7999f25","6afda059-04a5-4308-b776-a532ed142284","Italy",238,6,5,4,9,11,35,2430,2664,4946,2517,3495,16052
"0cd83ffd-f258-4775-a358-c55074060d88","6afda059-04a5-4308-b776-a532ed142284","Italy",238,9,20,14,5,12,60,2968,4941,2290,1626,3437,15262
"5b5b9eb7-f06a-48a3-b3e8-675a7f2faf18","6afda059-04a5-4308-b776-a532ed142284","Italy",238,2,3,3,5,5,18,690,904,488,1195,2222,5499
"38c90b27-ea8c-4111-a922-4e81390fefab","f61f9030-d814-495d-af95-0e643697de64","Brazil",352,1,3,1,3,3,11,323,1545,1025,1288,1628,5809
"4436282c-7d0f-4334-ba8d-80b7cfe2b849","f61f9030-d814-495d-af95-0e643697de64","Brazil",352,1,3,2,1,4,11,230,364,154,493,793,2034
"98a2ab99-afcb-447e-ae8d-4b96b374e4d7","f61f9030-d814-495d-af95-0e643697de64","Brazil",352,1,5,10,3,14,33,626,2151,3098,2364,3519,11758
"6caef30c-9e58-4bd8-bf6a-e3dcac4256f1","f61f9030-d814-495d-af95-0e643697de64","Brazil",352,1,12,8,3,15,39,479,3650,2886,491,9224,16730
"c19419a4-de5b-4642-b925-120bf7999f25","f61f9030-d814-495d-af95-0e643697de64","Brazil",352,2,6,9,4,11,32,378,1728,2029,1654,5116,10905
"0cd83ffd-f258-4775-a358-c55074060d88","f61f9030-d814-495d-af95-0e643697de64","Brazil",352,2,6,7,10,17,42,382,1820,2130,3548,6042,13922
"5b5b9eb7-f06a-48a3-b3e8-675a7f2faf18","f61f9030-d814-495d-af95-0e643697de64","Brazil",352,2,6,7,7,13,35,281,1587,1594,2097,3845,9404
"38c90b27-ea8c-4111-a922-4e81390fefab","5445f170-12c1-48fc-9563-3709dd2993b0","Greece",980,2,3,0,8,10,23,390,1625,0,6378,3656,12049
"4436282c-7d0f-4334-ba8d-80b7cfe2b849","5445f170-12c1-48fc-9563-3709dd2993b0","Greece",980,2,3,2,2,3,12,792,780,274,985,1106,3937
"98a2ab99-afcb-447e-ae8d-4b96b374e4d7","5445f170-12c1-48fc-9563-3709dd2993b0","Greece",980,2,4,1,4,6,17,613,975,18,1447,2145,5198
"6caef30c-9e58-4bd8-bf6a-e3dcac4256f1","5445f170-12c1-48fc-9563-3709dd2993b0","Greece",980,1,2,2,3,5,13,589,814,156,365,2686,4610
"c19419a4-de5b-4642-b925-120bf7999f25","5445f170-12c1-48fc-9563-3709dd2993b0","Greece",980,4,8,7,4,9,32,1116,4155,1695,1346,6836,15148
"0cd83ffd-f258-4775-a358-c55074060d88","5445f170-12c1-48fc-9563-3709dd2993b0","Greece",980,2,7,8,5,18,40,529,964,2034,2742,7085,13354
"5b5b9eb7-f06a-48a3-b3e8-675a7f2faf18","5445f170-12c1-48fc-9563-3709dd2993b0","Greece",980,3,3,1,3,3,13,886,905,0,1336,1025,4152
