"id_tester","id_item","pays","num_stimulus","Temps_Z1","Temps_Z2","Temps_Z3","Temps_Z4","Temps_Z5","tps_tot"
"199d1269-1d8a-420a-a986-1f4f2ab4355f","34359006-f70f-438e-85d0-420cf2fe6944","Ukraine",156,2929,4762,199,661,1825,10376
"fd0537e8-3103-47f8-9998-44570bb8a45e","34359006-f70f-438e-85d0-420cf2fe6944","Ukraine",156,2104,4350,5595,158,3095,15302
"e433aa11-cdb7-4733-88a9-7067cf52299b","34359006-f70f-438e-85d0-420cf2fe6944","Ukraine",156,5919,5288,5003,948,1038,18196
"149c1889-4e83-4153-b763-54fb60e60d99","34359006-f70f-438e-85d0-420cf2fe6944","Ukraine",156,8734,5803,1142,1617,1894,19190
"14229a71-f44e-4149-9f3c-aa7415691eae","34359006-f70f-438e-85d0-420cf2fe6944","Ukraine",156,546,1573,1280,1729,2647,7775
"a724528f-7fe6-4ad6-bba1-21cb02db2af5","34359006-f70f-438e-85d0-420cf2fe6944","Ukraine",156,9137,5640,3141,1161,4510,23589
"4f5ae77c-6112-401a-93d1-3bf44bd1ccbe","34359006-f70f-438e-85d0-420cf2fe6944","Ukraine",156,887,140,0,984,1010,3021
"4f147d0e-54ac-4b89-a269-aaa7819fb0ef","34359006-f70f-438e-85d0-420cf2fe6944","Ukraine",156,1522,3127,580,2494,2803,10526
"c464d108-c77f-41e7-bcbc-d5855c9a7968","34359006-f70f-438e-85d0-420cf2fe6944","Ukraine",156,6834,2847,2152,1826,9656,23315
"b20e7a20-ca68-410c-8214-fbb92bfdfe17","34359006-f70f-438e-85d0-420cf2fe6944","Ukraine",156,79,661,2764,84,1826,5414
"131f7620-d15d-4560-86ab-564145745b9b","34359006-f70f-438e-85d0-420cf2fe6944","Ukraine",156,2361,2400,1693,1573,5580,13607
"131ecf76-b806-4557-b2c0-183a418357ba","34359006-f70f-438e-85d0-420cf2fe6944","Ukraine",156,801,434,265,0,494,1994
"9560482a-f0a3-4f68-a311-03d22aedbd05","34359006-f70f-438e-85d0-420cf2fe6944","Ukraine",156,2721,1708,1005,1560,3246,10240
"10e732f6-9a6a-474a-82e2-a4060fc8dffe","34359006-f70f-438e-85d0-420cf2fe6944","Ukraine",156,5646,4317,4932,611,752,16258
"646465ef-0ad6-44cc-bd31-de24e1487943","34359006-f70f-438e-85d0-420cf2fe6944","Ukraine",156,1622,1303,2789,1978,3403,11095
"aa2c1d96-ec88-4bcb-8d0e-e2b0c7632af1","34359006-f70f-438e-85d0-420cf2fe6944","Ukraine",156,2885,1626,840,2033,3854,11238
"9610f0dd-ff9f-4bd4-b311-459a04f965ca","34359006-f70f-438e-85d0-420cf2fe6944","Ukraine",156,2228,672,623,1108,2010,6641
"df6523cd-3270-4298-8d6f-00aa8e9455e6","34359006-f70f-438e-85d0-420cf2fe6944","Ukraine",156,962,353,379,6677,4159,12530
"54c68134-2c2a-4f2e-974b-32310830af0e","34359006-f70f-438e-85d0-420cf2fe6944","Ukraine",156,5509,4118,350,549,1092,11618
"055d198c-f8b0-47b7-9eb3-94fc57808f93","34359006-f70f-438e-85d0-420cf2fe6944","Ukraine",156,1694,3403,2456,0,1006,8559
"cea293cd-b0b1-40ea-8e71-756b3956e8ad","34359006-f70f-438e-85d0-420cf2fe6944","Ukraine",156,0,3352,5085,0,375,8812
"de86783a-ac86-419a-a230-dad6b421fba4","34359006-f70f-438e-85d0-420cf2fe6944","Ukraine",156,3576,1056,1035,254,960,6881
"919c7921-7cef-4620-a2fe-766180ed2fbb","34359006-f70f-438e-85d0-420cf2fe6944","Ukraine",156,1299,2176,1570,1198,1976,8219
"9f8068fd-f5cc-4e1a-946a-c9beb8b4d05a","34359006-f70f-438e-85d0-420cf2fe6944","Ukraine",156,1203,78,1358,1426,2141,6206
"06026e76-f9a4-4fb9-877d-bcd33373cdab","34359006-f70f-438e-85d0-420cf2fe6944","Ukraine",156,3976,8080,3880,588,2364,18888
"27e050a3-45e8-4076-9c25-32be9040da4e","34359006-f70f-438e-85d0-420cf2fe6944","Ukraine",156,3721,1810,0,1153,2054,8738
"4995f6d3-50ed-427d-9cf2-4ea0b81a229c","34359006-f70f-438e-85d0-420cf2fe6944","Ukraine",156,1226,1680,439,1292,1966,6603
"398e712a-fae6-451d-83c9-a7e500227e62","34359006-f70f-438e-85d0-420cf2fe6944","Ukraine",156,432,497,74,176,0,1179
"65681129-f83c-4293-9ce3-9d1429367fd0","34359006-f70f-438e-85d0-420cf2fe6944","Ukraine",156,99,3170,5341,1342,6744,16696
"035a43cf-cf88-4675-85e7-11eeb0b3641c","34359006-f70f-438e-85d0-420cf2fe6944","Ukraine",156,9675,6324,2017,4933,3972,26921
"aaf1dbcb-3748-4740-a2e0-58e7c1cb9f78","34359006-f70f-438e-85d0-420cf2fe6944","Ukraine",156,1210,536,781,998,1657,5182
"bf743fbf-9be2-49a1-bf7e-0b53276e6529","34359006-f70f-438e-85d0-420cf2fe6944","Ukraine",156,1377,1404,0,499,2108,5388
"cd0a0a46-7676-4bf0-ad03-2e83bd565fee","34359006-f70f-438e-85d0-420cf2fe6944","Ukraine",156,1149,1284,0,821,1265,4519
"9577727a-fa45-4185-9778-4a56a41cf0f6","34359006-f70f-438e-85d0-420cf2fe6944","Ukraine",156,1821,1639,1122,0,0,4582
"073891b7-a928-4ff0-83e3-56f4d1a6315e","34359006-f70f-438e-85d0-420cf2fe6944","Ukraine",156,2651,2739,221,1867,395,7873
"cc933e0b-091f-4ef4-bfc8-11f2076d4396","34359006-f70f-438e-85d0-420cf2fe6944","Ukraine",156,71,474,392,7563,2313,10813
"4ed0a862-3163-449b-bb48-ca8b9ce3add0","34359006-f70f-438e-85d0-420cf2fe6944","Ukraine",156,3895,8406,1868,1126,3834,19129
"473d2e90-02dd-483e-ad19-3966ec20050a","34359006-f70f-438e-85d0-420cf2fe6944","Ukraine",156,457,1507,1332,378,281,3955
"03964ff9-d24f-4a0a-a492-3a177e16eb11","34359006-f70f-438e-85d0-420cf2fe6944","Ukraine",156,1695,1767,935,637,1047,6081
"e87291fb-8da5-4c7a-af30-4413737f2401","34359006-f70f-438e-85d0-420cf2fe6944","Ukraine",156,2011,1412,461,1158,679,5721
"915ec45f-204b-411d-8ed7-7fdecb385e39","34359006-f70f-438e-85d0-420cf2fe6944","Ukraine",156,3670,7523,3481,5621,6160,26455
"199d1269-1d8a-420a-a986-1f4f2ab4355f","20f3c152-6ebf-49db-8e1a-00eebd99feb6","Finland",672,4101,2418,1791,5419,1584,15313
"fd0537e8-3103-47f8-9998-44570bb8a45e","20f3c152-6ebf-49db-8e1a-00eebd99feb6","Finland",672,2261,1606,2100,1858,5334,13159
"e433aa11-cdb7-4733-88a9-7067cf52299b","20f3c152-6ebf-49db-8e1a-00eebd99feb6","Finland",672,1191,659,5311,3041,2241,12443
"149c1889-4e83-4153-b763-54fb60e60d99","20f3c152-6ebf-49db-8e1a-00eebd99feb6","Finland",672,338,159,4503,10871,3074,18945
"14229a71-f44e-4149-9f3c-aa7415691eae","20f3c152-6ebf-49db-8e1a-00eebd99feb6","Finland",672,492,280,438,1778,957,3945
"a724528f-7fe6-4ad6-bba1-21cb02db2af5","20f3c152-6ebf-49db-8e1a-00eebd99feb6","Finland",672,1790,1783,4054,3103,4219,14949
"4f5ae77c-6112-401a-93d1-3bf44bd1ccbe","20f3c152-6ebf-49db-8e1a-00eebd99feb6","Finland",672,1828,674,869,1482,563,5416
"4f147d0e-54ac-4b89-a269-aaa7819fb0ef","20f3c152-6ebf-49db-8e1a-00eebd99feb6","Finland",672,3185,2492,1731,1414,1289,10111
"c464d108-c77f-41e7-bcbc-d5855c9a7968","20f3c152-6ebf-49db-8e1a-00eebd99feb6","Finland",672,6392,2212,5862,4635,6469,25570
"b20e7a20-ca68-410c-8214-fbb92bfdfe17","20f3c152-6ebf-49db-8e1a-00eebd99feb6","Finland",672,987,1202,233,716,279,3417
"131f7620-d15d-4560-86ab-564145745b9b","20f3c152-6ebf-49db-8e1a-00eebd99feb6","Finland",672,3474,6131,2010,2059,5521,19195
"131ecf76-b806-4557-b2c0-183a418357ba","20f3c152-6ebf-49db-8e1a-00eebd99feb6","Finland",672,0,0,2262,5168,1834,9264
"9560482a-f0a3-4f68-a311-03d22aedbd05","20f3c152-6ebf-49db-8e1a-00eebd99feb6","Finland",672,2240,1604,1589,1540,809,7782
"10e732f6-9a6a-474a-82e2-a4060fc8dffe","20f3c152-6ebf-49db-8e1a-00eebd99feb6","Finland",672,185,260,3693,3559,2305,10002
"646465ef-0ad6-44cc-bd31-de24e1487943","20f3c152-6ebf-49db-8e1a-00eebd99feb6","Finland",672,3514,1789,2573,2065,2306,12247
"aa2c1d96-ec88-4bcb-8d0e-e2b0c7632af1","20f3c152-6ebf-49db-8e1a-00eebd99feb6","Finland",672,5600,5322,2767,4680,2121,20490
"9610f0dd-ff9f-4bd4-b311-459a04f965ca","20f3c152-6ebf-49db-8e1a-00eebd99feb6","Finland",672,921,1963,1626,4046,2595,11151
"df6523cd-3270-4298-8d6f-00aa8e9455e6","20f3c152-6ebf-49db-8e1a-00eebd99feb6","Finland",672,6928,8148,507,1014,2694,19291
"54c68134-2c2a-4f2e-974b-32310830af0e","20f3c152-6ebf-49db-8e1a-00eebd99feb6","Finland",672,1092,1104,1376,5395,4783,13750
"055d198c-f8b0-47b7-9eb3-94fc57808f93","20f3c152-6ebf-49db-8e1a-00eebd99feb6","Finland",672,2122,1758,2659,1430,956,8925
"cea293cd-b0b1-40ea-8e71-756b3956e8ad","20f3c152-6ebf-49db-8e1a-00eebd99feb6","Finland",672,109,0,1500,2890,0,4499
"de86783a-ac86-419a-a230-dad6b421fba4","20f3c152-6ebf-49db-8e1a-00eebd99feb6","Finland",672,6290,6501,3857,3434,2094,22176
"919c7921-7cef-4620-a2fe-766180ed2fbb","20f3c152-6ebf-49db-8e1a-00eebd99feb6","Finland",672,1492,1802,514,2260,743,6811
"9f8068fd-f5cc-4e1a-946a-c9beb8b4d05a","20f3c152-6ebf-49db-8e1a-00eebd99feb6","Finland",672,1149,1369,1453,1070,1101,6142
"06026e76-f9a4-4fb9-877d-bcd33373cdab","20f3c152-6ebf-49db-8e1a-00eebd99feb6","Finland",672,249,394,2852,3553,2907,9955
"27e050a3-45e8-4076-9c25-32be9040da4e","20f3c152-6ebf-49db-8e1a-00eebd99feb6","Finland",672,1039,0,0,1109,1700,3848
"4995f6d3-50ed-427d-9cf2-4ea0b81a229c","20f3c152-6ebf-49db-8e1a-00eebd99feb6","Finland",672,1724,303,3018,1872,754,7671
"398e712a-fae6-451d-83c9-a7e500227e62","20f3c152-6ebf-49db-8e1a-00eebd99feb6","Finland",672,2745,1213,237,1122,0,5317
"65681129-f83c-4293-9ce3-9d1429367fd0","20f3c152-6ebf-49db-8e1a-00eebd99feb6","Finland",672,5403,4231,591,972,0,11197
"035a43cf-cf88-4675-85e7-11eeb0b3641c","20f3c152-6ebf-49db-8e1a-00eebd99feb6","Finland",672,1807,2368,3058,2825,1689,11747
"aaf1dbcb-3748-4740-a2e0-58e7c1cb9f78","20f3c152-6ebf-49db-8e1a-00eebd99feb6","Finland",672,3119,1948,1708,910,1717,9402
"bf743fbf-9be2-49a1-bf7e-0b53276e6529","20f3c152-6ebf-49db-8e1a-00eebd99feb6","Finland",672,2684,463,170,1390,1084,5791
"cd0a0a46-7676-4bf0-ad03-2e83bd565fee","20f3c152-6ebf-49db-8e1a-00eebd99feb6","Finland",672,1888,1190,319,7900,6117,17414
"9577727a-fa45-4185-9778-4a56a41cf0f6","20f3c152-6ebf-49db-8e1a-00eebd99feb6","Finland",672,1812,1307,2627,5194,4391,15331
"073891b7-a928-4ff0-83e3-56f4d1a6315e","20f3c152-6ebf-49db-8e1a-00eebd99feb6","Finland",672,2722,2907,495,2651,2841,11616
"cc933e0b-091f-4ef4-bfc8-11f2076d4396","20f3c152-6ebf-49db-8e1a-00eebd99feb6","Finland",672,2587,903,2716,1940,405,8551
"4ed0a862-3163-449b-bb48-ca8b9ce3add0","20f3c152-6ebf-49db-8e1a-00eebd99feb6","Finland",672,1077,1461,5893,4417,4019,16867
"473d2e90-02dd-483e-ad19-3966ec20050a","20f3c152-6ebf-49db-8e1a-00eebd99feb6","Finland",672,1307,1885,1856,3606,1723,10377
"03964ff9-d24f-4a0a-a492-3a177e16eb11","20f3c152-6ebf-49db-8e1a-00eebd99feb6","Finland",672,565,1334,2327,1624,2537,8387
"e87291fb-8da5-4c7a-af30-4413737f2401","20f3c152-6ebf-49db-8e1a-00eebd99feb6","Finland",672,0,0,2992,734,545,4271
"915ec45f-204b-411d-8ed7-7fdecb385e39","20f3c152-6ebf-49db-8e1a-00eebd99feb6","Finland",672,5353,2872,6144,7091,2524,23984
"199d1269-1d8a-420a-a986-1f4f2ab4355f","213479f7-39af-4b83-b0e9-4ba473d27429","Spain",756,241,3633,2757,3603,4858,15092
"fd0537e8-3103-47f8-9998-44570bb8a45e","213479f7-39af-4b83-b0e9-4ba473d27429","Spain",756,1605,3509,3337,7009,8177,23637
"e433aa11-cdb7-4733-88a9-7067cf52299b","213479f7-39af-4b83-b0e9-4ba473d27429","Spain",756,380,1523,1135,2742,6575,12355
"149c1889-4e83-4153-b763-54fb60e60d99","213479f7-39af-4b83-b0e9-4ba473d27429","Spain",756,0,0,0,1275,6953,8228
"14229a71-f44e-4149-9f3c-aa7415691eae","213479f7-39af-4b83-b0e9-4ba473d27429","Spain",756,463,2672,2722,1494,4839,12190
"a724528f-7fe6-4ad6-bba1-21cb02db2af5","213479f7-39af-4b83-b0e9-4ba473d27429","Spain",756,2348,720,1456,6408,9665,20597
"4f5ae77c-6112-401a-93d1-3bf44bd1ccbe","213479f7-39af-4b83-b0e9-4ba473d27429","Spain",756,995,802,692,441,1324,4254
"4f147d0e-54ac-4b89-a269-aaa7819fb0ef","213479f7-39af-4b83-b0e9-4ba473d27429","Spain",756,437,801,750,408,923,3319
"c464d108-c77f-41e7-bcbc-d5855c9a7968","213479f7-39af-4b83-b0e9-4ba473d27429","Spain",756,285,1251,698,966,2430,5630
"b20e7a20-ca68-410c-8214-fbb92bfdfe17","213479f7-39af-4b83-b0e9-4ba473d27429","Spain",756,1332,3937,2787,1939,3640,13635
"131f7620-d15d-4560-86ab-564145745b9b","213479f7-39af-4b83-b0e9-4ba473d27429","Spain",756,0,235,2124,414,5478,8251
"131ecf76-b806-4557-b2c0-183a418357ba","213479f7-39af-4b83-b0e9-4ba473d27429","Spain",756,0,0,0,1738,3590,5328
"9560482a-f0a3-4f68-a311-03d22aedbd05","213479f7-39af-4b83-b0e9-4ba473d27429","Spain",756,376,953,2625,1399,971,6324
"10e732f6-9a6a-474a-82e2-a4060fc8dffe","213479f7-39af-4b83-b0e9-4ba473d27429","Spain",756,0,0,0,1479,6069,7548
"646465ef-0ad6-44cc-bd31-de24e1487943","213479f7-39af-4b83-b0e9-4ba473d27429","Spain",756,3751,6146,4764,3806,6609,25076
"aa2c1d96-ec88-4bcb-8d0e-e2b0c7632af1","213479f7-39af-4b83-b0e9-4ba473d27429","Spain",756,1525,2520,3599,1189,3994,12827
"9610f0dd-ff9f-4bd4-b311-459a04f965ca","213479f7-39af-4b83-b0e9-4ba473d27429","Spain",756,564,263,827,1085,2431,5170
"df6523cd-3270-4298-8d6f-00aa8e9455e6","213479f7-39af-4b83-b0e9-4ba473d27429","Spain",756,2558,5428,6145,3141,8314,25586
"54c68134-2c2a-4f2e-974b-32310830af0e","213479f7-39af-4b83-b0e9-4ba473d27429","Spain",756,0,0,29,1564,6265,7858
"055d198c-f8b0-47b7-9eb3-94fc57808f93","213479f7-39af-4b83-b0e9-4ba473d27429","Spain",756,1452,1202,1930,1595,3007,9186
"cea293cd-b0b1-40ea-8e71-756b3956e8ad","213479f7-39af-4b83-b0e9-4ba473d27429","Spain",756,0,0,0,3093,1309,4402
"de86783a-ac86-419a-a230-dad6b421fba4","213479f7-39af-4b83-b0e9-4ba473d27429","Spain",756,629,2444,2081,1603,1428,8185
"919c7921-7cef-4620-a2fe-766180ed2fbb","213479f7-39af-4b83-b0e9-4ba473d27429","Spain",756,811,1159,1351,3297,5271,11889
"9f8068fd-f5cc-4e1a-946a-c9beb8b4d05a","213479f7-39af-4b83-b0e9-4ba473d27429","Spain",756,755,1668,1647,1522,2060,7652
"06026e76-f9a4-4fb9-877d-bcd33373cdab","213479f7-39af-4b83-b0e9-4ba473d27429","Spain",756,415,66,79,3006,3267,6833
"27e050a3-45e8-4076-9c25-32be9040da4e","213479f7-39af-4b83-b0e9-4ba473d27429","Spain",756,186,2889,2707,0,5424,11206
"4995f6d3-50ed-427d-9cf2-4ea0b81a229c","213479f7-39af-4b83-b0e9-4ba473d27429","Spain",756,1449,2648,1677,2950,5634,14358
"398e712a-fae6-451d-83c9-a7e500227e62","213479f7-39af-4b83-b0e9-4ba473d27429","Spain",756,796,2154,831,715,2593,7089
"65681129-f83c-4293-9ce3-9d1429367fd0","213479f7-39af-4b83-b0e9-4ba473d27429","Spain",756,125,1166,223,2005,1877,5396
"035a43cf-cf88-4675-85e7-11eeb0b3641c","213479f7-39af-4b83-b0e9-4ba473d27429","Spain",756,3204,2660,3785,2099,5570,17318
"aaf1dbcb-3748-4740-a2e0-58e7c1cb9f78","213479f7-39af-4b83-b0e9-4ba473d27429","Spain",756,726,1695,3270,1993,3523,11207
"bf743fbf-9be2-49a1-bf7e-0b53276e6529","213479f7-39af-4b83-b0e9-4ba473d27429","Spain",756,421,1413,1030,612,3947,7423
"cd0a0a46-7676-4bf0-ad03-2e83bd565fee","213479f7-39af-4b83-b0e9-4ba473d27429","Spain",756,0,0,0,1054,6246,7300
"9577727a-fa45-4185-9778-4a56a41cf0f6","213479f7-39af-4b83-b0e9-4ba473d27429","Spain",756,0,845,1078,168,4554,6645
"073891b7-a928-4ff0-83e3-56f4d1a6315e","213479f7-39af-4b83-b0e9-4ba473d27429","Spain",756,0,1548,1089,0,4948,7585
"cc933e0b-091f-4ef4-bfc8-11f2076d4396","213479f7-39af-4b83-b0e9-4ba473d27429","Spain",756,778,3245,2977,790,6013,13803
"4ed0a862-3163-449b-bb48-ca8b9ce3add0","213479f7-39af-4b83-b0e9-4ba473d27429","Spain",756,214,775,1263,2159,4636,9047
"473d2e90-02dd-483e-ad19-3966ec20050a","213479f7-39af-4b83-b0e9-4ba473d27429","Spain",756,377,1643,1386,1053,2931,7390
"03964ff9-d24f-4a0a-a492-3a177e16eb11","213479f7-39af-4b83-b0e9-4ba473d27429","Spain",756,491,0,0,1178,2402,4071
"e87291fb-8da5-4c7a-af30-4413737f2401","213479f7-39af-4b83-b0e9-4ba473d27429","Spain",756,0,0,0,938,2094,3032
"915ec45f-204b-411d-8ed7-7fdecb385e39","213479f7-39af-4b83-b0e9-4ba473d27429","Spain",756,2246,6791,4055,5065,8039,26196
"199d1269-1d8a-420a-a986-1f4f2ab4355f","7bdf6ed6-acf9-4a7b-84fe-7e4f96f9582a","France",421,567,1916,701,3838,0,7022
"fd0537e8-3103-47f8-9998-44570bb8a45e","7bdf6ed6-acf9-4a7b-84fe-7e4f96f9582a","France",421,943,449,0,1718,2295,5405
"e433aa11-cdb7-4733-88a9-7067cf52299b","7bdf6ed6-acf9-4a7b-84fe-7e4f96f9582a","France",421,2085,764,358,6642,988,10837
"149c1889-4e83-4153-b763-54fb60e60d99","7bdf6ed6-acf9-4a7b-84fe-7e4f96f9582a","France",421,580,1814,1099,8684,663,12840
"14229a71-f44e-4149-9f3c-aa7415691eae","7bdf6ed6-acf9-4a7b-84fe-7e4f96f9582a","France",421,3056,3311,2439,3698,241,12745
"a724528f-7fe6-4ad6-bba1-21cb02db2af5","7bdf6ed6-acf9-4a7b-84fe-7e4f96f9582a","France",421,1080,2556,2381,9594,1653,17264
"4f5ae77c-6112-401a-93d1-3bf44bd1ccbe","7bdf6ed6-acf9-4a7b-84fe-7e4f96f9582a","France",421,914,84,911,1495,697,4101
"4f147d0e-54ac-4b89-a269-aaa7819fb0ef","7bdf6ed6-acf9-4a7b-84fe-7e4f96f9582a","France",421,1095,2563,473,3084,1195,8410
"c464d108-c77f-41e7-bcbc-d5855c9a7968","7bdf6ed6-acf9-4a7b-84fe-7e4f96f9582a","France",421,724,1976,2902,3842,1620,11064
"b20e7a20-ca68-410c-8214-fbb92bfdfe17","7bdf6ed6-acf9-4a7b-84fe-7e4f96f9582a","France",421,123,524,0,503,2080,3230
"131f7620-d15d-4560-86ab-564145745b9b","7bdf6ed6-acf9-4a7b-84fe-7e4f96f9582a","France",421,224,435,0,2229,616,3504
"131ecf76-b806-4557-b2c0-183a418357ba","7bdf6ed6-acf9-4a7b-84fe-7e4f96f9582a","France",421,0,0,0,4755,617,5372
"9560482a-f0a3-4f68-a311-03d22aedbd05","7bdf6ed6-acf9-4a7b-84fe-7e4f96f9582a","France",421,1036,903,1013,1487,1492,5931
"10e732f6-9a6a-474a-82e2-a4060fc8dffe","7bdf6ed6-acf9-4a7b-84fe-7e4f96f9582a","France",421,0,225,0,4118,1687,6030
"646465ef-0ad6-44cc-bd31-de24e1487943","7bdf6ed6-acf9-4a7b-84fe-7e4f96f9582a","France",421,7320,13543,315,1608,1398,24184
"aa2c1d96-ec88-4bcb-8d0e-e2b0c7632af1","7bdf6ed6-acf9-4a7b-84fe-7e4f96f9582a","France",421,972,2528,3608,5460,1503,14071
"9610f0dd-ff9f-4bd4-b311-459a04f965ca","7bdf6ed6-acf9-4a7b-84fe-7e4f96f9582a","France",421,0,171,0,3166,890,4227
"df6523cd-3270-4298-8d6f-00aa8e9455e6","7bdf6ed6-acf9-4a7b-84fe-7e4f96f9582a","France",421,992,1939,5001,2301,665,10898
"54c68134-2c2a-4f2e-974b-32310830af0e","7bdf6ed6-acf9-4a7b-84fe-7e4f96f9582a","France",421,0,0,206,2747,107,3060
"055d198c-f8b0-47b7-9eb3-94fc57808f93","7bdf6ed6-acf9-4a7b-84fe-7e4f96f9582a","France",421,2867,4100,2882,4245,1442,15536
"cea293cd-b0b1-40ea-8e71-756b3956e8ad","7bdf6ed6-acf9-4a7b-84fe-7e4f96f9582a","France",421,0,0,0,1108,587,1695
"de86783a-ac86-419a-a230-dad6b421fba4","7bdf6ed6-acf9-4a7b-84fe-7e4f96f9582a","France",421,1136,1459,805,5754,1259,10413
"919c7921-7cef-4620-a2fe-766180ed2fbb","7bdf6ed6-acf9-4a7b-84fe-7e4f96f9582a","France",421,1261,1389,0,3542,4284,10476
"9f8068fd-f5cc-4e1a-946a-c9beb8b4d05a","7bdf6ed6-acf9-4a7b-84fe-7e4f96f9582a","France",421,1472,1361,526,1699,563,5621
"06026e76-f9a4-4fb9-877d-bcd33373cdab","7bdf6ed6-acf9-4a7b-84fe-7e4f96f9582a","France",421,0,0,0,1399,81,1480
"27e050a3-45e8-4076-9c25-32be9040da4e","7bdf6ed6-acf9-4a7b-84fe-7e4f96f9582a","France",421,0,811,1892,3818,0,6521
"4995f6d3-50ed-427d-9cf2-4ea0b81a229c","7bdf6ed6-acf9-4a7b-84fe-7e4f96f9582a","France",421,4584,4335,3227,6409,4092,22647
"398e712a-fae6-451d-83c9-a7e500227e62","7bdf6ed6-acf9-4a7b-84fe-7e4f96f9582a","France",421,434,1350,685,420,0,2889
"65681129-f83c-4293-9ce3-9d1429367fd0","7bdf6ed6-acf9-4a7b-84fe-7e4f96f9582a","France",421,3152,3136,3590,3497,1216,14591
"035a43cf-cf88-4675-85e7-11eeb0b3641c","7bdf6ed6-acf9-4a7b-84fe-7e4f96f9582a","France",421,286,1535,379,2514,1238,5952
"aaf1dbcb-3748-4740-a2e0-58e7c1cb9f78","7bdf6ed6-acf9-4a7b-84fe-7e4f96f9582a","France",421,1772,2528,1187,5031,1646,12164
"bf743fbf-9be2-49a1-bf7e-0b53276e6529","7bdf6ed6-acf9-4a7b-84fe-7e4f96f9582a","France",421,0,1006,3093,4420,246,8765
"cd0a0a46-7676-4bf0-ad03-2e83bd565fee","7bdf6ed6-acf9-4a7b-84fe-7e4f96f9582a","France",421,0,2463,2557,3743,291,9054
"9577727a-fa45-4185-9778-4a56a41cf0f6","7bdf6ed6-acf9-4a7b-84fe-7e4f96f9582a","France",421,0,1202,0,6499,0,7701
"073891b7-a928-4ff0-83e3-56f4d1a6315e","7bdf6ed6-acf9-4a7b-84fe-7e4f96f9582a","France",421,0,511,126,6979,752,8368
"cc933e0b-091f-4ef4-bfc8-11f2076d4396","7bdf6ed6-acf9-4a7b-84fe-7e4f96f9582a","France",421,108,4327,5758,2055,247,12495
"4ed0a862-3163-449b-bb48-ca8b9ce3add0","7bdf6ed6-acf9-4a7b-84fe-7e4f96f9582a","France",421,0,535,506,5926,163,7130
"473d2e90-02dd-483e-ad19-3966ec20050a","7bdf6ed6-acf9-4a7b-84fe-7e4f96f9582a","France",421,213,155,407,1931,343,3049
"03964ff9-d24f-4a0a-a492-3a177e16eb11","7bdf6ed6-acf9-4a7b-84fe-7e4f96f9582a","France",421,573,274,0,3721,1387,5955
"e87291fb-8da5-4c7a-af30-4413737f2401","7bdf6ed6-acf9-4a7b-84fe-7e4f96f9582a","France",421,419,289,0,1668,1257,3633
"915ec45f-204b-411d-8ed7-7fdecb385e39","7bdf6ed6-acf9-4a7b-84fe-7e4f96f9582a","France",421,836,3685,5169,9545,2361,21596
"199d1269-1d8a-420a-a986-1f4f2ab4355f","cc2a8b56-732c-4e4c-a058-248783b68587","South Korea",489,2474,3124,4512,6273,7513,23896
"fd0537e8-3103-47f8-9998-44570bb8a45e","cc2a8b56-732c-4e4c-a058-248783b68587","South Korea",489,1575,3155,1378,2971,6897,15976
"e433aa11-cdb7-4733-88a9-7067cf52299b","cc2a8b56-732c-4e4c-a058-248783b68587","South Korea",489,3264,481,605,3935,1856,10141
"149c1889-4e83-4153-b763-54fb60e60d99","cc2a8b56-732c-4e4c-a058-248783b68587","South Korea",489,0,0,0,6347,4302,10649
"14229a71-f44e-4149-9f3c-aa7415691eae","cc2a8b56-732c-4e4c-a058-248783b68587","South Korea",489,1067,2322,2889,3529,5718,15525
"a724528f-7fe6-4ad6-bba1-21cb02db2af5","cc2a8b56-732c-4e4c-a058-248783b68587","South Korea",489,1156,1443,3636,6301,10516,23052
"4f5ae77c-6112-401a-93d1-3bf44bd1ccbe","cc2a8b56-732c-4e4c-a058-248783b68587","South Korea",489,502,272,840,1303,1945,4862
"4f147d0e-54ac-4b89-a269-aaa7819fb0ef","cc2a8b56-732c-4e4c-a058-248783b68587","South Korea",489,1081,1595,1223,2455,5021,11375
"c464d108-c77f-41e7-bcbc-d5855c9a7968","cc2a8b56-732c-4e4c-a058-248783b68587","South Korea",489,2518,2124,4357,6254,7243,22496
"b20e7a20-ca68-410c-8214-fbb92bfdfe17","cc2a8b56-732c-4e4c-a058-248783b68587","South Korea",489,1411,2385,860,1324,944,6924
"131f7620-d15d-4560-86ab-564145745b9b","cc2a8b56-732c-4e4c-a058-248783b68587","South Korea",489,185,848,0,2570,6000,9603
"131ecf76-b806-4557-b2c0-183a418357ba","cc2a8b56-732c-4e4c-a058-248783b68587","South Korea",489,0,0,0,2780,772,3552
"9560482a-f0a3-4f68-a311-03d22aedbd05","cc2a8b56-732c-4e4c-a058-248783b68587","South Korea",489,1288,360,709,681,530,3568
"10e732f6-9a6a-474a-82e2-a4060fc8dffe","cc2a8b56-732c-4e4c-a058-248783b68587","South Korea",489,0,0,0,2848,4457,7305
"646465ef-0ad6-44cc-bd31-de24e1487943","cc2a8b56-732c-4e4c-a058-248783b68587","South Korea",489,4356,8074,3075,1773,8023,25301
"aa2c1d96-ec88-4bcb-8d0e-e2b0c7632af1","cc2a8b56-732c-4e4c-a058-248783b68587","South Korea",489,2086,1991,1901,2819,4090,12887
"9610f0dd-ff9f-4bd4-b311-459a04f965ca","cc2a8b56-732c-4e4c-a058-248783b68587","South Korea",489,913,1006,686,2942,3928,9475
"df6523cd-3270-4298-8d6f-00aa8e9455e6","cc2a8b56-732c-4e4c-a058-248783b68587","South Korea",489,0,1772,7522,1609,4650,15553
"54c68134-2c2a-4f2e-974b-32310830af0e","cc2a8b56-732c-4e4c-a058-248783b68587","South Korea",489,0,507,2143,5106,11929,19685
"055d198c-f8b0-47b7-9eb3-94fc57808f93","cc2a8b56-732c-4e4c-a058-248783b68587","South Korea",489,1713,1300,1645,347,3538,8543
"cea293cd-b0b1-40ea-8e71-756b3956e8ad","cc2a8b56-732c-4e4c-a058-248783b68587","South Korea",489,0,0,0,393,705,1098
"de86783a-ac86-419a-a230-dad6b421fba4","cc2a8b56-732c-4e4c-a058-248783b68587","South Korea",489,677,1533,1759,3020,3272,10261
"919c7921-7cef-4620-a2fe-766180ed2fbb","cc2a8b56-732c-4e4c-a058-248783b68587","South Korea",489,2176,1631,2644,2952,4750,14153
"9f8068fd-f5cc-4e1a-946a-c9beb8b4d05a","cc2a8b56-732c-4e4c-a058-248783b68587","South Korea",489,656,94,289,0,1559,2598
"06026e76-f9a4-4fb9-877d-bcd33373cdab","cc2a8b56-732c-4e4c-a058-248783b68587","South Korea",489,265,178,256,1333,1920,3952
"27e050a3-45e8-4076-9c25-32be9040da4e","cc2a8b56-732c-4e4c-a058-248783b68587","South Korea",489,0,544,910,0,2854,4308
"4995f6d3-50ed-427d-9cf2-4ea0b81a229c","cc2a8b56-732c-4e4c-a058-248783b68587","South Korea",489,409,808,1265,3173,6804,12459
"398e712a-fae6-451d-83c9-a7e500227e62","cc2a8b56-732c-4e4c-a058-248783b68587","South Korea",489,691,1005,1903,0,0,3599
"65681129-f83c-4293-9ce3-9d1429367fd0","cc2a8b56-732c-4e4c-a058-248783b68587","South Korea",489,872,2071,6280,4964,3856,18043
"035a43cf-cf88-4675-85e7-11eeb0b3641c","cc2a8b56-732c-4e4c-a058-248783b68587","South Korea",489,2316,3980,4480,6105,11007,27888
"aaf1dbcb-3748-4740-a2e0-58e7c1cb9f78","cc2a8b56-732c-4e4c-a058-248783b68587","South Korea",489,1169,444,632,1973,2411,6629
"bf743fbf-9be2-49a1-bf7e-0b53276e6529","cc2a8b56-732c-4e4c-a058-248783b68587","South Korea",489,173,528,484,2053,1866,5104
"cd0a0a46-7676-4bf0-ad03-2e83bd565fee","cc2a8b56-732c-4e4c-a058-248783b68587","South Korea",489,0,1057,148,823,7258,9286
"9577727a-fa45-4185-9778-4a56a41cf0f6","cc2a8b56-732c-4e4c-a058-248783b68587","South Korea",489,0,310,226,462,3893,4891
"073891b7-a928-4ff0-83e3-56f4d1a6315e","cc2a8b56-732c-4e4c-a058-248783b68587","South Korea",489,0,0,0,4771,6143,10914
"cc933e0b-091f-4ef4-bfc8-11f2076d4396","cc2a8b56-732c-4e4c-a058-248783b68587","South Korea",489,624,1659,2049,2505,12167,19004
"4ed0a862-3163-449b-bb48-ca8b9ce3add0","cc2a8b56-732c-4e4c-a058-248783b68587","South Korea",489,1328,521,784,1509,1665,5807
"473d2e90-02dd-483e-ad19-3966ec20050a","cc2a8b56-732c-4e4c-a058-248783b68587","South Korea",489,350,666,34,1544,1351,3945
"03964ff9-d24f-4a0a-a492-3a177e16eb11","cc2a8b56-732c-4e4c-a058-248783b68587","South Korea",489,1622,11,267,3032,3460,8392
"e87291fb-8da5-4c7a-af30-4413737f2401","cc2a8b56-732c-4e4c-a058-248783b68587","South Korea",489,842,437,445,827,1943,4494
"915ec45f-204b-411d-8ed7-7fdecb385e39","cc2a8b56-732c-4e4c-a058-248783b68587","South Korea",489,1157,2176,2420,5668,10270,21691
"199d1269-1d8a-420a-a986-1f4f2ab4355f","dd13fcba-0ae1-43d3-9d32-1672ed84f151","USA",327,3257,3524,1857,5705,11631,25974
"fd0537e8-3103-47f8-9998-44570bb8a45e","dd13fcba-0ae1-43d3-9d32-1672ed84f151","USA",327,2132,471,1302,1269,4704,9878
"e433aa11-cdb7-4733-88a9-7067cf52299b","dd13fcba-0ae1-43d3-9d32-1672ed84f151","USA",327,292,413,329,1004,2656,4694
"149c1889-4e83-4153-b763-54fb60e60d99","dd13fcba-0ae1-43d3-9d32-1672ed84f151","USA",327,286,0,0,1581,7291,9158
"14229a71-f44e-4149-9f3c-aa7415691eae","dd13fcba-0ae1-43d3-9d32-1672ed84f151","USA",327,1601,6109,1018,3703,13198,25629
"a724528f-7fe6-4ad6-bba1-21cb02db2af5","dd13fcba-0ae1-43d3-9d32-1672ed84f151","USA",327,956,546,0,2287,4201,7990
"4f5ae77c-6112-401a-93d1-3bf44bd1ccbe","dd13fcba-0ae1-43d3-9d32-1672ed84f151","USA",327,425,426,31,586,1957,3425
"4f147d0e-54ac-4b89-a269-aaa7819fb0ef","dd13fcba-0ae1-43d3-9d32-1672ed84f151","USA",327,672,1099,318,977,4601,7667
"c464d108-c77f-41e7-bcbc-d5855c9a7968","dd13fcba-0ae1-43d3-9d32-1672ed84f151","USA",327,3626,691,1277,4717,8670,18981
"b20e7a20-ca68-410c-8214-fbb92bfdfe17","dd13fcba-0ae1-43d3-9d32-1672ed84f151","USA",327,3680,533,0,1336,1064,6613
"131f7620-d15d-4560-86ab-564145745b9b","dd13fcba-0ae1-43d3-9d32-1672ed84f151","USA",327,0,0,0,1502,4486,5988
"131ecf76-b806-4557-b2c0-183a418357ba","dd13fcba-0ae1-43d3-9d32-1672ed84f151","USA",327,361,0,0,1146,2713,4220
"9560482a-f0a3-4f68-a311-03d22aedbd05","dd13fcba-0ae1-43d3-9d32-1672ed84f151","USA",327,791,381,269,549,903,2893
"10e732f6-9a6a-474a-82e2-a4060fc8dffe","dd13fcba-0ae1-43d3-9d32-1672ed84f151","USA",327,0,0,0,883,1974,2857
"646465ef-0ad6-44cc-bd31-de24e1487943","dd13fcba-0ae1-43d3-9d32-1672ed84f151","USA",327,3387,6848,4050,637,7983,22905
"aa2c1d96-ec88-4bcb-8d0e-e2b0c7632af1","dd13fcba-0ae1-43d3-9d32-1672ed84f151","USA",327,3290,1545,3158,2720,5428,16141
"9610f0dd-ff9f-4bd4-b311-459a04f965ca","dd13fcba-0ae1-43d3-9d32-1672ed84f151","USA",327,729,68,0,1866,4141,6804
"df6523cd-3270-4298-8d6f-00aa8e9455e6","dd13fcba-0ae1-43d3-9d32-1672ed84f151","USA",327,671,2044,2667,206,1512,7100
"54c68134-2c2a-4f2e-974b-32310830af0e","dd13fcba-0ae1-43d3-9d32-1672ed84f151","USA",327,1299,1168,960,292,3688,7407
"055d198c-f8b0-47b7-9eb3-94fc57808f93","dd13fcba-0ae1-43d3-9d32-1672ed84f151","USA",327,928,503,1027,751,1003,4212
"cea293cd-b0b1-40ea-8e71-756b3956e8ad","dd13fcba-0ae1-43d3-9d32-1672ed84f151","USA",327,0,0,0,835,782,1617
"de86783a-ac86-419a-a230-dad6b421fba4","dd13fcba-0ae1-43d3-9d32-1672ed84f151","USA",327,0,0,0,1941,4552,6493
"919c7921-7cef-4620-a2fe-766180ed2fbb","dd13fcba-0ae1-43d3-9d32-1672ed84f151","USA",327,1667,1195,778,4265,8885,16790
"9f8068fd-f5cc-4e1a-946a-c9beb8b4d05a","dd13fcba-0ae1-43d3-9d32-1672ed84f151","USA",327,2233,998,1308,1216,2963,8718
"06026e76-f9a4-4fb9-877d-bcd33373cdab","dd13fcba-0ae1-43d3-9d32-1672ed84f151","USA",327,49,321,0,3106,2954,6430
"27e050a3-45e8-4076-9c25-32be9040da4e","dd13fcba-0ae1-43d3-9d32-1672ed84f151","USA",327,687,1159,1650,0,8894,12390
"4995f6d3-50ed-427d-9cf2-4ea0b81a229c","dd13fcba-0ae1-43d3-9d32-1672ed84f151","USA",327,1538,2513,547,996,4862,10456
"398e712a-fae6-451d-83c9-a7e500227e62","dd13fcba-0ae1-43d3-9d32-1672ed84f151","USA",327,1093,191,177,140,745,2346
"65681129-f83c-4293-9ce3-9d1429367fd0","dd13fcba-0ae1-43d3-9d32-1672ed84f151","USA",327,1930,1586,1966,4457,2721,12660
"035a43cf-cf88-4675-85e7-11eeb0b3641c","dd13fcba-0ae1-43d3-9d32-1672ed84f151","USA",327,2206,1418,1259,1793,3970,10646
"aaf1dbcb-3748-4740-a2e0-58e7c1cb9f78","dd13fcba-0ae1-43d3-9d32-1672ed84f151","USA",327,402,482,352,1131,1768,4135
"bf743fbf-9be2-49a1-bf7e-0b53276e6529","dd13fcba-0ae1-43d3-9d32-1672ed84f151","USA",327,0,576,359,687,7085,8707
"cd0a0a46-7676-4bf0-ad03-2e83bd565fee","dd13fcba-0ae1-43d3-9d32-1672ed84f151","USA",327,365,841,357,640,4492,6695
"9577727a-fa45-4185-9778-4a56a41cf0f6","dd13fcba-0ae1-43d3-9d32-1672ed84f151","USA",327,0,14,107,680,3389,4190
"073891b7-a928-4ff0-83e3-56f4d1a6315e","dd13fcba-0ae1-43d3-9d32-1672ed84f151","USA",327,0,566,209,2621,12665,16061
"cc933e0b-091f-4ef4-bfc8-11f2076d4396","dd13fcba-0ae1-43d3-9d32-1672ed84f151","USA",327,1136,2466,328,2571,5868,12369
"4ed0a862-3163-449b-bb48-ca8b9ce3add0","dd13fcba-0ae1-43d3-9d32-1672ed84f151","USA",327,954,621,1343,3140,6934,12992
"473d2e90-02dd-483e-ad19-3966ec20050a","dd13fcba-0ae1-43d3-9d32-1672ed84f151","USA",327,418,323,34,942,3016,4733
"03964ff9-d24f-4a0a-a492-3a177e16eb11","dd13fcba-0ae1-43d3-9d32-1672ed84f151","USA",327,63,611,173,392,564,1803
"e87291fb-8da5-4c7a-af30-4413737f2401","dd13fcba-0ae1-43d3-9d32-1672ed84f151","USA",327,1253,0,181,1008,2745,5187
"915ec45f-204b-411d-8ed7-7fdecb385e39","dd13fcba-0ae1-43d3-9d32-1672ed84f151","USA",327,2377,508,964,2342,4505,10696
"199d1269-1d8a-420a-a986-1f4f2ab4355f","6afda059-04a5-4308-b776-a532ed142284","Italy",238,1307,4426,434,2002,8239,16408
"fd0537e8-3103-47f8-9998-44570bb8a45e","6afda059-04a5-4308-b776-a532ed142284","Italy",238,4238,1885,419,1362,4546,12450
"e433aa11-cdb7-4733-88a9-7067cf52299b","6afda059-04a5-4308-b776-a532ed142284","Italy",238,155,152,0,8435,2970,11712
"149c1889-4e83-4153-b763-54fb60e60d99","6afda059-04a5-4308-b776-a532ed142284","Italy",238,260,605,288,1159,6716,9028
"14229a71-f44e-4149-9f3c-aa7415691eae","6afda059-04a5-4308-b776-a532ed142284","Italy",238,661,1592,944,1805,5081,10083
"a724528f-7fe6-4ad6-bba1-21cb02db2af5","6afda059-04a5-4308-b776-a532ed142284","Italy",238,1601,399,0,4539,12192,18731
"4f5ae77c-6112-401a-93d1-3bf44bd1ccbe","6afda059-04a5-4308-b776-a532ed142284","Italy",238,942,1843,371,29,1141,4326
"4f147d0e-54ac-4b89-a269-aaa7819fb0ef","6afda059-04a5-4308-b776-a532ed142284","Italy",238,826,1762,209,1028,6598,10423
"c464d108-c77f-41e7-bcbc-d5855c9a7968","6afda059-04a5-4308-b776-a532ed142284","Italy",238,2176,399,470,3628,7626,14299
"b20e7a20-ca68-410c-8214-fbb92bfdfe17","6afda059-04a5-4308-b776-a532ed142284","Italy",238,928,1178,416,1299,2051,5872
"131f7620-d15d-4560-86ab-564145745b9b","6afda059-04a5-4308-b776-a532ed142284","Italy",238,0,2466,4803,2452,7123,16844
"131ecf76-b806-4557-b2c0-183a418357ba","6afda059-04a5-4308-b776-a532ed142284","Italy",238,233,0,0,1356,3585,5174
"9560482a-f0a3-4f68-a311-03d22aedbd05","6afda059-04a5-4308-b776-a532ed142284","Italy",238,635,555,218,517,2409,4334
"10e732f6-9a6a-474a-82e2-a4060fc8dffe","6afda059-04a5-4308-b776-a532ed142284","Italy",238,716,119,144,4643,7452,13074
"646465ef-0ad6-44cc-bd31-de24e1487943","6afda059-04a5-4308-b776-a532ed142284","Italy",238,665,2164,962,1963,12159,17913
"aa2c1d96-ec88-4bcb-8d0e-e2b0c7632af1","6afda059-04a5-4308-b776-a532ed142284","Italy",238,1425,1116,1264,1820,3135,8760
"9610f0dd-ff9f-4bd4-b311-459a04f965ca","6afda059-04a5-4308-b776-a532ed142284","Italy",238,1216,975,575,1972,5562,10300
"df6523cd-3270-4298-8d6f-00aa8e9455e6","6afda059-04a5-4308-b776-a532ed142284","Italy",238,3121,4350,2373,2047,3859,15750
"54c68134-2c2a-4f2e-974b-32310830af0e","6afda059-04a5-4308-b776-a532ed142284","Italy",238,1684,1101,687,3119,6224,12815
"055d198c-f8b0-47b7-9eb3-94fc57808f93","6afda059-04a5-4308-b776-a532ed142284","Italy",238,5323,5418,3683,2451,9491,26366
"cea293cd-b0b1-40ea-8e71-756b3956e8ad","6afda059-04a5-4308-b776-a532ed142284","Italy",238,0,0,0,2158,454,2612
"de86783a-ac86-419a-a230-dad6b421fba4","6afda059-04a5-4308-b776-a532ed142284","Italy",238,859,2961,433,1030,3386,8669
"919c7921-7cef-4620-a2fe-766180ed2fbb","6afda059-04a5-4308-b776-a532ed142284","Italy",238,329,720,1425,757,4782,8013
"9f8068fd-f5cc-4e1a-946a-c9beb8b4d05a","6afda059-04a5-4308-b776-a532ed142284","Italy",238,1239,1699,805,1186,1835,6764
"06026e76-f9a4-4fb9-877d-bcd33373cdab","6afda059-04a5-4308-b776-a532ed142284","Italy",238,306,0,330,2936,5621,9193
"27e050a3-45e8-4076-9c25-32be9040da4e","6afda059-04a5-4308-b776-a532ed142284","Italy",238,734,2196,1582,234,4662,9408
"4995f6d3-50ed-427d-9cf2-4ea0b81a229c","6afda059-04a5-4308-b776-a532ed142284","Italy",238,553,712,0,3105,1198,5568
"398e712a-fae6-451d-83c9-a7e500227e62","6afda059-04a5-4308-b776-a532ed142284","Italy",238,678,868,1224,184,348,3302
"65681129-f83c-4293-9ce3-9d1429367fd0","6afda059-04a5-4308-b776-a532ed142284","Italy",238,3010,4003,2467,703,2690,12873
"035a43cf-cf88-4675-85e7-11eeb0b3641c","6afda059-04a5-4308-b776-a532ed142284","Italy",238,1821,2236,1202,677,2853,8789
"aaf1dbcb-3748-4740-a2e0-58e7c1cb9f78","6afda059-04a5-4308-b776-a532ed142284","Italy",238,1335,2381,929,3346,5344,13335
"bf743fbf-9be2-49a1-bf7e-0b53276e6529","6afda059-04a5-4308-b776-a532ed142284","Italy",238,266,2057,328,8140,5998,16789
"cd0a0a46-7676-4bf0-ad03-2e83bd565fee","6afda059-04a5-4308-b776-a532ed142284","Italy",238,1644,1232,417,1500,8071,12864
"9577727a-fa45-4185-9778-4a56a41cf0f6","6afda059-04a5-4308-b776-a532ed142284","Italy",238,168,187,0,649,4305,5309
"073891b7-a928-4ff0-83e3-56f4d1a6315e","6afda059-04a5-4308-b776-a532ed142284","Italy",238,479,278,2952,258,5436,9403
"cc933e0b-091f-4ef4-bfc8-11f2076d4396","6afda059-04a5-4308-b776-a532ed142284","Italy",238,4207,3049,1278,3781,9152,21467
"4ed0a862-3163-449b-bb48-ca8b9ce3add0","6afda059-04a5-4308-b776-a532ed142284","Italy",238,385,1447,1392,2102,5391,10717
"473d2e90-02dd-483e-ad19-3966ec20050a","6afda059-04a5-4308-b776-a532ed142284","Italy",238,478,1283,186,1651,4746,8344
"03964ff9-d24f-4a0a-a492-3a177e16eb11","6afda059-04a5-4308-b776-a532ed142284","Italy",238,0,0,0,3193,1727,4920
"e87291fb-8da5-4c7a-af30-4413737f2401","6afda059-04a5-4308-b776-a532ed142284","Italy",238,636,420,0,1018,2630,4704
"915ec45f-204b-411d-8ed7-7fdecb385e39","6afda059-04a5-4308-b776-a532ed142284","Italy",238,789,2361,2046,5093,6251,16540
"199d1269-1d8a-420a-a986-1f4f2ab4355f","f61f9030-d814-495d-af95-0e643697de64","Brazil",352,1608,4260,2585,6889,5941,21283
"fd0537e8-3103-47f8-9998-44570bb8a45e","f61f9030-d814-495d-af95-0e643697de64","Brazil",352,571,4551,531,2944,7305,15902
"e433aa11-cdb7-4733-88a9-7067cf52299b","f61f9030-d814-495d-af95-0e643697de64","Brazil",352,684,4698,866,4592,8724,19564
"149c1889-4e83-4153-b763-54fb60e60d99","f61f9030-d814-495d-af95-0e643697de64","Brazil",352,0,1692,443,3705,5359,11199
"14229a71-f44e-4149-9f3c-aa7415691eae","f61f9030-d814-495d-af95-0e643697de64","Brazil",352,1534,3255,3344,4499,5069,17701
"a724528f-7fe6-4ad6-bba1-21cb02db2af5","f61f9030-d814-495d-af95-0e643697de64","Brazil",352,2145,3881,49,7808,10674,24557
"4f5ae77c-6112-401a-93d1-3bf44bd1ccbe","f61f9030-d814-495d-af95-0e643697de64","Brazil",352,189,1085,430,589,1033,3326
"4f147d0e-54ac-4b89-a269-aaa7819fb0ef","f61f9030-d814-495d-af95-0e643697de64","Brazil",352,836,1883,498,1967,1734,6918
"c464d108-c77f-41e7-bcbc-d5855c9a7968","f61f9030-d814-495d-af95-0e643697de64","Brazil",352,1796,5027,3629,4236,2701,17389
"b20e7a20-ca68-410c-8214-fbb92bfdfe17","f61f9030-d814-495d-af95-0e643697de64","Brazil",352,1328,1703,1069,1920,1117,7137
"131f7620-d15d-4560-86ab-564145745b9b","f61f9030-d814-495d-af95-0e643697de64","Brazil",352,252,1664,648,5880,12003,20447
"131ecf76-b806-4557-b2c0-183a418357ba","f61f9030-d814-495d-af95-0e643697de64","Brazil",352,0,0,0,1611,3621,5232
"9560482a-f0a3-4f68-a311-03d22aedbd05","f61f9030-d814-495d-af95-0e643697de64","Brazil",352,528,312,1063,1108,1546,4557
"10e732f6-9a6a-474a-82e2-a4060fc8dffe","f61f9030-d814-495d-af95-0e643697de64","Brazil",352,231,0,0,3465,9019,12715
"646465ef-0ad6-44cc-bd31-de24e1487943","f61f9030-d814-495d-af95-0e643697de64","Brazil",352,1439,6576,2322,7393,5477,23207
"aa2c1d96-ec88-4bcb-8d0e-e2b0c7632af1","f61f9030-d814-495d-af95-0e643697de64","Brazil",352,1636,2726,1584,2615,2418,10979
"9610f0dd-ff9f-4bd4-b311-459a04f965ca","f61f9030-d814-495d-af95-0e643697de64","Brazil",352,275,159,0,2262,5567,8263
"df6523cd-3270-4298-8d6f-00aa8e9455e6","f61f9030-d814-495d-af95-0e643697de64","Brazil",352,0,4844,4043,2288,2118,13293
"54c68134-2c2a-4f2e-974b-32310830af0e","f61f9030-d814-495d-af95-0e643697de64","Brazil",352,179,400,338,1362,4182,6461
"055d198c-f8b0-47b7-9eb3-94fc57808f93","f61f9030-d814-495d-af95-0e643697de64","Brazil",352,2799,5176,4418,5100,5007,22500
"cea293cd-b0b1-40ea-8e71-756b3956e8ad","f61f9030-d814-495d-af95-0e643697de64","Brazil",352,0,0,0,2995,1003,3998
"de86783a-ac86-419a-a230-dad6b421fba4","f61f9030-d814-495d-af95-0e643697de64","Brazil",352,1211,2632,1345,2843,3490,11521
"919c7921-7cef-4620-a2fe-766180ed2fbb","f61f9030-d814-495d-af95-0e643697de64","Brazil",352,1437,1483,1913,2094,4408,11335
"9f8068fd-f5cc-4e1a-946a-c9beb8b4d05a","f61f9030-d814-495d-af95-0e643697de64","Brazil",352,785,1497,922,1273,1950,6427
"06026e76-f9a4-4fb9-877d-bcd33373cdab","f61f9030-d814-495d-af95-0e643697de64","Brazil",352,190,325,115,4129,6839,11598
"27e050a3-45e8-4076-9c25-32be9040da4e","f61f9030-d814-495d-af95-0e643697de64","Brazil",352,0,3449,1459,246,9071,14225
"4995f6d3-50ed-427d-9cf2-4ea0b81a229c","f61f9030-d814-495d-af95-0e643697de64","Brazil",352,1418,1236,2638,1833,5371,12496
"398e712a-fae6-451d-83c9-a7e500227e62","f61f9030-d814-495d-af95-0e643697de64","Brazil",352,628,3229,2817,2329,317,9320
"65681129-f83c-4293-9ce3-9d1429367fd0","f61f9030-d814-495d-af95-0e643697de64","Brazil",352,2813,4949,691,2450,663,11566
"035a43cf-cf88-4675-85e7-11eeb0b3641c","f61f9030-d814-495d-af95-0e643697de64","Brazil",352,2213,6222,9289,4509,7227,29460
"aaf1dbcb-3748-4740-a2e0-58e7c1cb9f78","f61f9030-d814-495d-af95-0e643697de64","Brazil",352,1427,1963,4017,2651,4787,14845
"bf743fbf-9be2-49a1-bf7e-0b53276e6529","f61f9030-d814-495d-af95-0e643697de64","Brazil",352,0,1682,3092,889,4635,10298
"cd0a0a46-7676-4bf0-ad03-2e83bd565fee","f61f9030-d814-495d-af95-0e643697de64","Brazil",352,660,670,1565,2605,6504,12004
"9577727a-fa45-4185-9778-4a56a41cf0f6","f61f9030-d814-495d-af95-0e643697de64","Brazil",352,0,0,0,835,796,1631
"073891b7-a928-4ff0-83e3-56f4d1a6315e","f61f9030-d814-495d-af95-0e643697de64","Brazil",352,0,994,1678,317,4932,7921
"cc933e0b-091f-4ef4-bfc8-11f2076d4396","f61f9030-d814-495d-af95-0e643697de64","Brazil",352,1254,5920,2089,1700,3794,14757
"4ed0a862-3163-449b-bb48-ca8b9ce3add0","f61f9030-d814-495d-af95-0e643697de64","Brazil",352,593,2196,1114,5298,7362,16563
"473d2e90-02dd-483e-ad19-3966ec20050a","f61f9030-d814-495d-af95-0e643697de64","Brazil",352,65,465,202,724,2847,4303
"03964ff9-d24f-4a0a-a492-3a177e16eb11","f61f9030-d814-495d-af95-0e643697de64","Brazil",352,987,303,0,2775,3448,7513
"e87291fb-8da5-4c7a-af30-4413737f2401","f61f9030-d814-495d-af95-0e643697de64","Brazil",352,815,624,0,1729,2453,5621
"915ec45f-204b-411d-8ed7-7fdecb385e39","f61f9030-d814-495d-af95-0e643697de64","Brazil",352,372,2282,3987,2829,10578,20048
"199d1269-1d8a-420a-a986-1f4f2ab4355f","5445f170-12c1-48fc-9563-3709dd2993b0","Greece",980,1145,5076,338,595,2012,9166
"fd0537e8-3103-47f8-9998-44570bb8a45e","5445f170-12c1-48fc-9563-3709dd2993b0","Greece",980,1148,1987,585,28,5791,9539
"e433aa11-cdb7-4733-88a9-7067cf52299b","5445f170-12c1-48fc-9563-3709dd2993b0","Greece",980,0,356,1017,7794,7093,16260
"149c1889-4e83-4153-b763-54fb60e60d99","5445f170-12c1-48fc-9563-3709dd2993b0","Greece",980,0,0,0,1068,2606,3674
"14229a71-f44e-4149-9f3c-aa7415691eae","5445f170-12c1-48fc-9563-3709dd2993b0","Greece",980,1475,1697,953,2151,6311,12587
"a724528f-7fe6-4ad6-bba1-21cb02db2af5","5445f170-12c1-48fc-9563-3709dd2993b0","Greece",980,380,2073,1809,2557,9481,16300
"4f5ae77c-6112-401a-93d1-3bf44bd1ccbe","5445f170-12c1-48fc-9563-3709dd2993b0","Greece",980,318,611,617,618,2077,4241
"4f147d0e-54ac-4b89-a269-aaa7819fb0ef","5445f170-12c1-48fc-9563-3709dd2993b0","Greece",980,815,2413,1021,413,2034,6696
"c464d108-c77f-41e7-bcbc-d5855c9a7968","5445f170-12c1-48fc-9563-3709dd2993b0","Greece",980,4143,1261,870,4588,5480,16342
"b20e7a20-ca68-410c-8214-fbb92bfdfe17","5445f170-12c1-48fc-9563-3709dd2993b0","Greece",980,466,99,0,1535,44,2144
"131f7620-d15d-4560-86ab-564145745b9b","5445f170-12c1-48fc-9563-3709dd2993b0","Greece",980,178,1622,2716,1318,11452,17286
"131ecf76-b806-4557-b2c0-183a418357ba","5445f170-12c1-48fc-9563-3709dd2993b0","Greece",980,0,0,0,878,2785,3663
"9560482a-f0a3-4f68-a311-03d22aedbd05","5445f170-12c1-48fc-9563-3709dd2993b0","Greece",980,776,1074,1161,766,2193,5970
"10e732f6-9a6a-474a-82e2-a4060fc8dffe","5445f170-12c1-48fc-9563-3709dd2993b0","Greece",980,388,0,0,3085,9982,13455
"646465ef-0ad6-44cc-bd31-de24e1487943","5445f170-12c1-48fc-9563-3709dd2993b0","Greece",980,2578,4018,802,375,10302,18075
"aa2c1d96-ec88-4bcb-8d0e-e2b0c7632af1","5445f170-12c1-48fc-9563-3709dd2993b0","Greece",980,677,854,756,890,1881,5058
"9610f0dd-ff9f-4bd4-b311-459a04f965ca","5445f170-12c1-48fc-9563-3709dd2993b0","Greece",980,283,770,47,851,4844,6795
"df6523cd-3270-4298-8d6f-00aa8e9455e6","5445f170-12c1-48fc-9563-3709dd2993b0","Greece",980,1714,3198,3953,2369,6976,18210
"54c68134-2c2a-4f2e-974b-32310830af0e","5445f170-12c1-48fc-9563-3709dd2993b0","Greece",980,252,970,0,1416,9668,12306
"055d198c-f8b0-47b7-9eb3-94fc57808f93","5445f170-12c1-48fc-9563-3709dd2993b0","Greece",980,1714,2035,1334,4590,8580,18253
"cea293cd-b0b1-40ea-8e71-756b3956e8ad","5445f170-12c1-48fc-9563-3709dd2993b0","Greece",980,0,0,0,1349,1753,3102
"de86783a-ac86-419a-a230-dad6b421fba4","5445f170-12c1-48fc-9563-3709dd2993b0","Greece",980,599,1535,98,1132,4317,7681
"919c7921-7cef-4620-a2fe-766180ed2fbb","5445f170-12c1-48fc-9563-3709dd2993b0","Greece",980,556,1505,31,3017,1843,6952
"9f8068fd-f5cc-4e1a-946a-c9beb8b4d05a","5445f170-12c1-48fc-9563-3709dd2993b0","Greece",980,1398,1389,1390,1567,4327,10071
"06026e76-f9a4-4fb9-877d-bcd33373cdab","5445f170-12c1-48fc-9563-3709dd2993b0","Greece",980,313,165,29,4853,3610,8970
"27e050a3-45e8-4076-9c25-32be9040da4e","5445f170-12c1-48fc-9563-3709dd2993b0","Greece",980,196,4168,680,245,6380,11669
"4995f6d3-50ed-427d-9cf2-4ea0b81a229c","5445f170-12c1-48fc-9563-3709dd2993b0","Greece",980,0,544,551,5165,1345,7605
"398e712a-fae6-451d-83c9-a7e500227e62","5445f170-12c1-48fc-9563-3709dd2993b0","Greece",980,1026,1503,2197,240,857,5823
"65681129-f83c-4293-9ce3-9d1429367fd0","5445f170-12c1-48fc-9563-3709dd2993b0","Greece",980,1222,3183,517,34,778,5734
"035a43cf-cf88-4675-85e7-11eeb0b3641c","5445f170-12c1-48fc-9563-3709dd2993b0","Greece",980,1126,3983,3781,2095,9168,20153
"aaf1dbcb-3748-4740-a2e0-58e7c1cb9f78","5445f170-12c1-48fc-9563-3709dd2993b0","Greece",980,2281,1380,684,1448,3788,9581
"bf743fbf-9be2-49a1-bf7e-0b53276e6529","5445f170-12c1-48fc-9563-3709dd2993b0","Greece",980,0,626,599,463,2751,4439
"cd0a0a46-7676-4bf0-ad03-2e83bd565fee","5445f170-12c1-48fc-9563-3709dd2993b0","Greece",980,1610,1239,1942,1025,6537,12353
"9577727a-fa45-4185-9778-4a56a41cf0f6","5445f170-12c1-48fc-9563-3709dd2993b0","Greece",980,0,0,0,352,1163,1515
"073891b7-a928-4ff0-83e3-56f4d1a6315e","5445f170-12c1-48fc-9563-3709dd2993b0","Greece",980,0,749,1397,0,3982,6128
"cc933e0b-091f-4ef4-bfc8-11f2076d4396","5445f170-12c1-48fc-9563-3709dd2993b0","Greece",980,2233,2521,0,7433,2473,14660
"4ed0a862-3163-449b-bb48-ca8b9ce3add0","5445f170-12c1-48fc-9563-3709dd2993b0","Greece",980,631,140,156,2048,8512,11487
"473d2e90-02dd-483e-ad19-3966ec20050a","5445f170-12c1-48fc-9563-3709dd2993b0","Greece",980,2143,907,787,1077,4353,9267
"03964ff9-d24f-4a0a-a492-3a177e16eb11","5445f170-12c1-48fc-9563-3709dd2993b0","Greece",980,0,0,0,1959,3355,5314
"e87291fb-8da5-4c7a-af30-4413737f2401","5445f170-12c1-48fc-9563-3709dd2993b0","Greece",980,1337,1159,913,1114,1945,6468
"915ec45f-204b-411d-8ed7-7fdecb385e39","5445f170-12c1-48fc-9563-3709dd2993b0","Greece",980,1905,3120,2086,6717,12917,26745
"38c90b27-ea8c-4111-a922-4e81390fefab","34359006-f70f-438e-85d0-420cf2fe6944","Ukraine",156,1439,1085,380,632,1102,4638
"4436282c-7d0f-4334-ba8d-80b7cfe2b849","34359006-f70f-438e-85d0-420cf2fe6944","Ukraine",156,546,1262,254,96,314,2472
"98a2ab99-afcb-447e-ae8d-4b96b374e4d7","34359006-f70f-438e-85d0-420cf2fe6944","Ukraine",156,1998,510,0,2216,3228,7952
"6caef30c-9e58-4bd8-bf6a-e3dcac4256f1","34359006-f70f-438e-85d0-420cf2fe6944","Ukraine",156,2879,897,0,366,703,4845
"c19419a4-de5b-4642-b925-120bf7999f25","34359006-f70f-438e-85d0-420cf2fe6944","Ukraine",156,0,1962,2753,1296,2563,8574
"0cd83ffd-f258-4775-a358-c55074060d88","34359006-f70f-438e-85d0-420cf2fe6944","Ukraine",156,3089,1807,605,3573,2976,12050
"5b5b9eb7-f06a-48a3-b3e8-675a7f2faf18","34359006-f70f-438e-85d0-420cf2fe6944","Ukraine",156,0,156,1499,0,773,2428
"38c90b27-ea8c-4111-a922-4e81390fefab","20f3c152-6ebf-49db-8e1a-00eebd99feb6","Finland",672,4849,1031,1697,2009,1149,10735
"4436282c-7d0f-4334-ba8d-80b7cfe2b849","20f3c152-6ebf-49db-8e1a-00eebd99feb6","Finland",672,1638,593,1090,1247,1474,6042
"98a2ab99-afcb-447e-ae8d-4b96b374e4d7","20f3c152-6ebf-49db-8e1a-00eebd99feb6","Finland",672,2153,1709,836,1420,368,6486
"6caef30c-9e58-4bd8-bf6a-e3dcac4256f1","20f3c152-6ebf-49db-8e1a-00eebd99feb6","Finland",672,516,714,507,1559,174,3470
"c19419a4-de5b-4642-b925-120bf7999f25","20f3c152-6ebf-49db-8e1a-00eebd99feb6","Finland",672,425,173,3141,2719,6277,12735
"0cd83ffd-f258-4775-a358-c55074060d88","20f3c152-6ebf-49db-8e1a-00eebd99feb6","Finland",672,2857,3918,1722,1881,1969,12347
"5b5b9eb7-f06a-48a3-b3e8-675a7f2faf18","20f3c152-6ebf-49db-8e1a-00eebd99feb6","Finland",672,1526,974,285,445,776,4006
"38c90b27-ea8c-4111-a922-4e81390fefab","213479f7-39af-4b83-b0e9-4ba473d27429","Spain",756,1555,625,758,1884,1593,6415
"4436282c-7d0f-4334-ba8d-80b7cfe2b849","213479f7-39af-4b83-b0e9-4ba473d27429","Spain",756,422,892,1403,948,3047,6712
"98a2ab99-afcb-447e-ae8d-4b96b374e4d7","213479f7-39af-4b83-b0e9-4ba473d27429","Spain",756,1392,1270,1756,2293,2878,9589
"6caef30c-9e58-4bd8-bf6a-e3dcac4256f1","213479f7-39af-4b83-b0e9-4ba473d27429","Spain",756,123,192,794,250,1045,2404
"c19419a4-de5b-4642-b925-120bf7999f25","213479f7-39af-4b83-b0e9-4ba473d27429","Spain",756,1517,631,433,4375,1135,8091
"0cd83ffd-f258-4775-a358-c55074060d88","213479f7-39af-4b83-b0e9-4ba473d27429","Spain",756,2015,3310,5429,2315,9475,22544
"5b5b9eb7-f06a-48a3-b3e8-675a7f2faf18","213479f7-39af-4b83-b0e9-4ba473d27429","Spain",756,213,1408,589,1187,1333,4730
"38c90b27-ea8c-4111-a922-4e81390fefab","7bdf6ed6-acf9-4a7b-84fe-7e4f96f9582a","France",421,4417,3565,1545,5470,2064,17061
"4436282c-7d0f-4334-ba8d-80b7cfe2b849","7bdf6ed6-acf9-4a7b-84fe-7e4f96f9582a","France",421,0,0,408,1372,669,2449
"98a2ab99-afcb-447e-ae8d-4b96b374e4d7","7bdf6ed6-acf9-4a7b-84fe-7e4f96f9582a","France",421,585,1415,955,2499,30,5484
"6caef30c-9e58-4bd8-bf6a-e3dcac4256f1","7bdf6ed6-acf9-4a7b-84fe-7e4f96f9582a","France",421,169,717,79,3305,309,4579
"c19419a4-de5b-4642-b925-120bf7999f25","7bdf6ed6-acf9-4a7b-84fe-7e4f96f9582a","France",421,434,1778,362,5133,1135,8842
"0cd83ffd-f258-4775-a358-c55074060d88","7bdf6ed6-acf9-4a7b-84fe-7e4f96f9582a","France",421,231,1803,361,4396,650,7441
"5b5b9eb7-f06a-48a3-b3e8-675a7f2faf18","7bdf6ed6-acf9-4a7b-84fe-7e4f96f9582a","France",421,0,108,447,2174,255,2984
"38c90b27-ea8c-4111-a922-4e81390fefab","cc2a8b56-732c-4e4c-a058-248783b68587","South Korea",489,93,702,377,2836,3598,7606
"4436282c-7d0f-4334-ba8d-80b7cfe2b849","cc2a8b56-732c-4e4c-a058-248783b68587","South Korea",489,0,34,197,1067,2551,3849
"98a2ab99-afcb-447e-ae8d-4b96b374e4d7","cc2a8b56-732c-4e4c-a058-248783b68587","South Korea",489,685,1241,2885,522,4504,9837
"6caef30c-9e58-4bd8-bf6a-e3dcac4256f1","cc2a8b56-732c-4e4c-a058-248783b68587","South Korea",489,0,15,0,2252,4107,6374
"c19419a4-de5b-4642-b925-120bf7999f25","cc2a8b56-732c-4e4c-a058-248783b68587","South Korea",489,514,322,492,2864,2722,6914
"0cd83ffd-f258-4775-a358-c55074060d88","cc2a8b56-732c-4e4c-a058-248783b68587","South Korea",489,350,1038,3003,1508,3679,9578
"5b5b9eb7-f06a-48a3-b3e8-675a7f2faf18","cc2a8b56-732c-4e4c-a058-248783b68587","South Korea",489,318,532,3096,129,5133,9208
"38c90b27-ea8c-4111-a922-4e81390fefab","dd13fcba-0ae1-43d3-9d32-1672ed84f151","USA",327,3110,621,0,1239,1405,6375
"4436282c-7d0f-4334-ba8d-80b7cfe2b849","dd13fcba-0ae1-43d3-9d32-1672ed84f151","USA",327,628,850,318,643,1976,4415
"98a2ab99-afcb-447e-ae8d-4b96b374e4d7","dd13fcba-0ae1-43d3-9d32-1672ed84f151","USA",327,1166,979,522,954,2001,5622
"6caef30c-9e58-4bd8-bf6a-e3dcac4256f1","dd13fcba-0ae1-43d3-9d32-1672ed84f151","USA",327,0,636,126,0,5846,6608
"c19419a4-de5b-4642-b925-120bf7999f25","dd13fcba-0ae1-43d3-9d32-1672ed84f151","USA",327,2396,1500,0,6868,6438,17202
"0cd83ffd-f258-4775-a358-c55074060d88","dd13fcba-0ae1-43d3-9d32-1672ed84f151","USA",327,441,758,414,842,10136,12591
"5b5b9eb7-f06a-48a3-b3e8-675a7f2faf18","dd13fcba-0ae1-43d3-9d32-1672ed84f151","USA",327,0,237,406,0,945,1588
"38c90b27-ea8c-4111-a922-4e81390fefab","6afda059-04a5-4308-b776-a532ed142284","Italy",238,1116,1565,49,1047,2167,5944
"4436282c-7d0f-4334-ba8d-80b7cfe2b849","6afda059-04a5-4308-b776-a532ed142284","Italy",238,230,499,239,218,1424,2610
"98a2ab99-afcb-447e-ae8d-4b96b374e4d7","6afda059-04a5-4308-b776-a532ed142284","Italy",238,319,2971,2509,636,7589,14024
"6caef30c-9e58-4bd8-bf6a-e3dcac4256f1","6afda059-04a5-4308-b776-a532ed142284","Italy",238,367,719,241,313,2528,4168
"c19419a4-de5b-4642-b925-120bf7999f25","6afda059-04a5-4308-b776-a532ed142284","Italy",238,3250,4565,360,4141,1957,14273
"0cd83ffd-f258-4775-a358-c55074060d88","6afda059-04a5-4308-b776-a532ed142284","Italy",238,0,368,1396,1374,10084,13222
"5b5b9eb7-f06a-48a3-b3e8-675a7f2faf18","6afda059-04a5-4308-b776-a532ed142284","Italy",238,0,307,453,1759,2488,5007
"38c90b27-ea8c-4111-a922-4e81390fefab","f61f9030-d814-495d-af95-0e643697de64","Brazil",352,1137,493,733,1225,1166,4754
"4436282c-7d0f-4334-ba8d-80b7cfe2b849","f61f9030-d814-495d-af95-0e643697de64","Brazil",352,230,364,154,493,793,2034
"98a2ab99-afcb-447e-ae8d-4b96b374e4d7","f61f9030-d814-495d-af95-0e643697de64","Brazil",352,626,2151,3098,2364,3519,11758
"6caef30c-9e58-4bd8-bf6a-e3dcac4256f1","f61f9030-d814-495d-af95-0e643697de64","Brazil",352,479,3650,2886,491,9224,16730
"c19419a4-de5b-4642-b925-120bf7999f25","f61f9030-d814-495d-af95-0e643697de64","Brazil",352,378,1728,2029,1654,5116,10905
"0cd83ffd-f258-4775-a358-c55074060d88","f61f9030-d814-495d-af95-0e643697de64","Brazil",352,382,1820,2130,3548,6042,13922
"5b5b9eb7-f06a-48a3-b3e8-675a7f2faf18","f61f9030-d814-495d-af95-0e643697de64","Brazil",352,281,1587,1594,2097,3845,9404
"38c90b27-ea8c-4111-a922-4e81390fefab","5445f170-12c1-48fc-9563-3709dd2993b0","Greece",980,390,1625,0,6378,3656,12049
"4436282c-7d0f-4334-ba8d-80b7cfe2b849","5445f170-12c1-48fc-9563-3709dd2993b0","Greece",980,237,442,162,1286,2037,4164
"98a2ab99-afcb-447e-ae8d-4b96b374e4d7","5445f170-12c1-48fc-9563-3709dd2993b0","Greece",980,359,807,45,1107,2341,4659
"6caef30c-9e58-4bd8-bf6a-e3dcac4256f1","5445f170-12c1-48fc-9563-3709dd2993b0","Greece",980,589,814,156,365,2686,4610
"c19419a4-de5b-4642-b925-120bf7999f25","5445f170-12c1-48fc-9563-3709dd2993b0","Greece",980,623,1855,477,1988,7423,12366
"0cd83ffd-f258-4775-a358-c55074060d88","5445f170-12c1-48fc-9563-3709dd2993b0","Greece",980,529,964,2034,2742,7085,13354
"5b5b9eb7-f06a-48a3-b3e8-675a7f2faf18","5445f170-12c1-48fc-9563-3709dd2993b0","Greece",980,886,905,0,1336,1025,4152
